下周一（5.7日）手上持有这些股的要小心	news_finance
猪伪狂犬苗的免疫方案怎么做？	news_edu
小米7未到！这两款小米手机目前性价比最高，米粉：可惜买不到	news_tech
任何指望技术来解决社会公正、公平的设想，都是幻想	news_tech
诸葛亮能借东风火烧曹营，为什么火烧司马懿却没料到会下雨？	news_culture
福利几款旅行必备神器，便宜实用颜值高！	news_travel
抵押车要怎样年审和购买保险？	news_car
现在一万一平米的房子，十年后大概卖多少钱？	news_house
第一位有中国国籍的外国人，留中国五十多年，死前留下这样的话！	news_world
为什么A股投资者越保护越亏？	stock
美智库：中国科研经费飙升装备加速突破将损害美国优先	news_world
在淘宝上面做分销商，怎么发货？	news_tech
证券时报：资本市场法律尊严不容戏弄	stock
经常会听见楼上有类似玻璃珠掉落，还有人走动的声音，但是楼上没有人啊，为什么？	news_story
2018年5月5日加州鲈、大黄鱼、牛蛙、太阳鱼、鲫鱼塘头价行情简析	news_agriculture
Minecraft1.1.2版本中如何让实体方块能穿透（玩家能穿过）？	news_tech
你怎么看待父亲精神分裂，母亲下肢残疾的他高考却被清华录取？	news_edu
五粮液股票可以继续持有吗？	stock
老汉好心请三个秀才吃饭，锅里只放一粒米、一滴水！	news_story
如果美国将国债一次性还清，会发生什么事！	news_finance
女工身上有异味尿裤子被嘲笑，发现用尿不湿后同事黯然落泪	news_story
谢娜曾为他与主办方撕破脸！谢娜复出快本！他第一个到场支持！	news_entertainment
A股是否已经进入下行通道，这种时候应该怎么操作？	stock
上联：屋后梅花三两亩；求下联怎么对？	news_culture
张翰公布新恋情？发文：有你的世界，一切才恢复色彩！	news_entertainment
车工的前世今生——从车工的成长看995的未来	news_entertainment
当年美国向日本扔原子弹的地方，现在怎么样了？	news_military
七律·洛阳牡丹	news_culture
美术书影：刘继卣绘制的图书插图原稿赏析	news_culture
铭硕言5.6黄金非农急催拉盘空单扫尾，亏损该怎么对待后市	news_finance
温格主场能否完美谢幕？来看看博彩公司的意图！	news_sports
名爵ZS这款车使用感觉怎么样，为什么买这款车？	news_car
中兴通讯：关于重大事项进展公告	news_finance
力压武松成为梁山第一都头，朱仝为何排在打虎英雄之前	news_story
你怎么看待以色列在一夜之间盗走伊朗上吨核文件这种行为？	news_military
预算15万，个子矮的女生适合开什么车？	news_car
你愿意把十万元人民币存入支付宝，还是存入微信钱包？	news_tech
90后女生告诉我：买房比结婚重要	news_house
五角大楼清醒认识到一个现实：在这些领域中国正在迎头赶上！	news_military
股市分析：从猪肉跌至10年低位看到的投机机会！	news_agriculture
工作不顺我请高人指点，对方看完扭身就逃：你早死了	news_story
币圈重磅：BTC牛市已来，教你如何把握抄底时机！	news_finance
七年级男孩子学习不自觉怎么办？	news_edu
王者荣耀有哪些辅助可以出全输出装？	news_game
王者荣耀：有这个英雄在，辅助位都能变成团战中心	news_game
10国上门求购2000枚中国鱼雷	news_military
DNF：安徒恩比卢克好在哪？为什么许多勇士都喜欢乌龟讨厌卢克	news_game
火箭被爵士打出9-0反击，保罗，哈登为此争吵，从中我们能够看出什么？	news_sports
以色列警告称如果战机被击落将会轰炸俄军事基地，你怎么看？	news_military
为了微信支付安全，请打开微信钱包这个功能吧	news_tech
平遥古城游记	news_travel
一处处秀丽的自然风光让您目不暇接 没去过的赶紧去	news_travel
一个新来东莞打工小妹的自白！稚嫩且真实，大家可以感受一下！	news_story
居全国GDP最高的省份，风景优美却物价低廉，节假日酒店从不加价	news_car
做到这几点，发动机用20年都不是问题！幸亏我知道得早	news_car
瞭望刊文：房地产税改革渐行渐近，还需突破四个阻力区	news_house
妖股第二次砸盘，欢乐海岸还会来反包吗？	news_finance
DNF中，你对你玩的职业有哪些不满的地方？	news_game
流浪狗扰乱正常教学秩序，破坏学生们生活，该怎么办？	news_edu
全新战术大放异彩！俄神器促力，叙政府军猛烈攻击，反叛武装溃逃	news_military
下联:夕陽西下已黄昏。上联是什麽？	news_culture
为什么很多企业家都说“未来投资房子是最大的错误”？	news_house
2018初级会计职称考试判断题怎样做才能不被倒扣分？新北会计培训	news_edu
以色列警告称如果战机被击落将会轰炸俄军事基地，你怎么看？	news_military
通过运动健身，你觉得对你最大的改变是什么？	news_sports
詹姆斯G3决杀，你怎么看？	news_sports
我国首座全潜式深海渔场5月4日在青岛交付使用	news_agriculture
虚拟货币-从EOS主网上线，巴菲特不看好虚拟货币解读虚拟货币	news_tech
细数上市银行“八宗最” 这些银行抢先了！	stock
想去三四线城市定居，首付有限，是先买个偏点儿的房子，还是再攒几年钱后买好地段的房子？	news_house
马克思是世界上最伟大的哲学家吗？	news_culture
世界第一伟人是谁？	news_travel
中国辽宁航母战斗群的战斗力如何？	news_military
如果安卓也像ios一样，不理智消费，可以申请退款，中国会有多少家公司要倒闭？	news_tech
美国建国不过两百年，为什么会成为世界强国？	news_world
婆媳之间，9条你不知道的秘密	news_story
如何看待房子的涨跌？普通人买房有希望吗？	news_house
如果股市很多股票连续下跌造成股票质押大面积爆仓，后果会怎么样？	stock
马化腾：从写第一行代码开始，我的理想都是如何做出最好的产品	news_tech
如何看待美国将长时间停止对"白头盔"组织的资金供应？	news_military
她曾因一部剧走红，但为了姐弟恋淡出荧幕，如今丈夫却红得了不起	news_entertainment
亚洲最善战的国家，四周全是敌国，天天打仗，至今比日韩还富裕！	news_world
上联是“轻风细雨相思泪”，怎么对下联？	news_culture
为什么打仗时，千万不能打跳伞的飞行员？	news_military
阿里巴巴准备扩张东南亚市场	news_tech
文化产业管理专业就业前景如何？	news_culture
珍藏版！2018俄罗斯世界杯赛程表，世界杯32强巡礼！	news_sports
向初梵；5.6周一黄金操作建议，下周黄金走势分析	news_finance
如何用最少的钱在北京市中心买房	news_house
郭敬明现身机场，粉丝跪地拍照？网友：这样做也太夸张了吧	news_entertainment
方向盘摆正时打死到底是多少圈？究竟是1.5圈还是2圈？	news_car
「王者荣耀」S11最强上单是他，梦琪和他有一拼	news_game
99家上市公司股东户数骤降 私募基金持股数量大增45%	stock
中国历史上六大顶级国宝级文物，传国玉玺才排第三，第一无可争议	news_culture
在5月5号虎牙索泰杯上，QM战队被实锤代打，如何评价？	news_game
朱啸虎姚劲波……互联网大佬纷纷表态《腾讯没有梦想》	news_tech
能成为世界第一大国，美国都做对了哪些事情？	news_world
卡拉斯科的底线过人和本泽马的哪个更优秀？	news_sports
绝地求生黄金大奖赛TPP模式奖金36万、FPP奖金10万 奖金差距好大	news_game
个股一旦出现什么信号，必须清仓卖出吗？	stock
谁在助燃高温的方大炭素？	stock
苹果或率先破万亿美元？苹果打响反击战 五天暴涨600亿美元	news_finance
老人工厂打工三十年，辞职前老板给了一箱水果，打开泪流满面	news_story
亚洲杯分组国足抽得上上签，国足就一定能出线吗？	news_sports
广州富力外援扎哈维的孩子，球场秀球技，颇有老爸的风采	news_sports
4000多观众齐聚镇雄实验中学，五月文化节文艺汇演嗨翻全场	news_edu
steam是否毁灭了中国游戏市场？	news_game
上海4月份住宅供应涨84.5%，成交量创8年来新低	news_house
孩子学习成绩全班倒数，为什么老师不能抽时间为孩子补补课，老师不应该帮孩子提高成绩吗？	news_edu
汽车小白的人生第一辆车，名爵6还是马自达昂克赛拉好？	news_car
山东滕州 南沙河镇	news_agriculture
一辈子就一次的大四毕业，该选择旅行还是抓紧时间实习？	news_travel
老牌私募操纵1股获利5000万 获亿级罚单	stock
网友数博会：大数据与实体经济融合发展，贵州焕发新动力	news_tech
世界上仅有的两个由发达变落后的国家，令人可惜	news_world
古代男人去世后，寡妇的生活有多凄惨，为何都住在村头？	news_story
GoogleI/O2018还有两天就要来临，我们期待着什么？	news_tech
有哪些科学解释不了的事实或现象？	news_world
运气太差？俄上苏30战机地中海坠毁原因成谜！一细节待解	news_military
娱乐圈最珍贵的友谊，最后两个因为一个女人而反目成仇！	news_entertainment
房价这么高，你觉得还有拼命干的必要吗？	news_house
什么叫打球要用脑，看看人家隆指导	news_sports
如果在距离地球500公里的太空引爆一颗五千万弹量的氢弹，会怎么样？	news_military
海富通FOF镀金未果 仓促建仓择时失败业绩陷泥潭	news_finance
宝马汽车14款首发车型，最重要的还是这2款……	news_car
马化腾说腾讯没有梦想，你还见过哪些牛人说过牛逼的话？	news_tech
高考选专业是自己决定还是由父母决定好？	news_edu
上联：对联，关耳何事，怎么对下联？	news_culture
4月CPI、进出口等数据将公布，这些投资机会最靠谱	news_finance
如果A股上市公司某天突然破产倒闭了，散户手中的股票该怎么办？	stock
玉米种子在播前，需要二次包衣吗？不需要或需要，又因为什么呢？	news_tech
你如何看待个人信息严重泄露的问题，这就是所谓的大数据吗？	news_tech
我在现场：与巴菲特一起寻找下一片投资的热土	news_finance
美国参议员麦凯恩说他的葬礼上不请特朗普，大家怎么看？	news_world
荥经县安靖小学开展春季田径运动会	news_sports
山东日照2018年买了房子之后，房价跌了怎么办？	news_house
越来越多女人出门带上这些东西，外出旅游更放心	news_travel
关于配额、新疆棉纺等话题，中棉行协第五届六次常务理事会作热议	news_finance
海南买房先签订购房合同，挂靠公司交两年社保，满两年后再过户，这样做靠谱吗？	news_house
腾讯市值超过阿里，但为什么在各种场合上，总是感觉阿里格局更高？	news_tech
吃鸡游戏里一百个人里哪些是人机？	news_game
一农村妇女搞养殖年入百万 能学到她的一半就能赚大钱	news_agriculture
靠花47亿维持的中国沙漠第一湖，旺季门票不下百元！	news_travel
金州勇士、皇家马德里，谁在世界上影响力大？	news_sports
一箭双雕！美民众点评特朗普“挺拥枪”：虚伪	news_world
东财的会计专硕在财经院校里水平怎么样？	news_edu
因主角演技“太烂”而放弃的电视剧，若你看完2部，我叫你大神！	news_entertainment
看完邱会作墓地，再看看黄永胜墓，意义深远，很少人去	news_culture
渭南新增少华山传说等7个省级非遗保护项目	news_culture
稻苗长的慢可以用二胺吗？怎么使它快速生长？	news_agriculture
他是中超唯一一个巴西主力 或成世界杯赛场中超最亮眼的名片	news_sports
网贷逾期后，既不催收也联系不到客服，却遭遇一天200元催收费	news_finance
如果现在是希拉里当总统，美国的外交政策会是什么样？	news_world
离愁不是三月雨，下联应该怎么对？	news_culture
国产航母尚未海试，其超强舰载机已试飞，俄：核心源自我们	news_military
美国参议员麦凯恩说他的葬礼上不请特朗普，大家怎么看？	news_world
前夫婚前贷款买的房子婚后他加了我名字，离婚之后我再买房子算不算首套住房？	news_house
刺激战场：光子现在都这么良心的吗？这空投让人两眼放光！	news_game
雷行记：来陕西旅游的朋友恭喜你，华山门票降价了！	news_travel
天龙八部手游：天命玄凤霸榜当之无愧！	news_game
那些怀孕还坚持拍戏的女明星，蔡少芬最敬业，她就有点尴尬了！	news_entertainment
连饭都吃不上	news_agriculture
生猛！这个女人当4年马刺助教，现在又要去应聘主教练！	news_sports
战略轰炸机的机组人员在执行长航时作战任务中，是怎么吃饭，睡觉和上厕所的？	news_military
8万搞定，这四款SUV懂车的人都会买，让吹飞度的人脸红	news_car
小心！小程序正在毁掉你的微信体验	news_game
高考试卷中的极化恒等式	news_edu
腾讯发布“00后画像报告” 颠覆我们对这一代的认知	news_tech
DNF武器加13成功是一种什么样的体验？	news_game
股市“最后一跌”有哪些特征？	stock
父亲消失母亲离世，4岁中非混血男孩跟随养母，却不愿当非洲人	news_story
同为17款手动的瑞虎5x豪华版和长安cs55炫色型，选哪个？	news_car
几乎每一个银行工作人员都劝说顾客，不要把钱存入余额宝，对此你怎么看？	news_tech
司马光砸缸的故事大家都知道，司马光救的那个人是谁，你知道吗？	news_story
市盈率为负数是什么意思？市盈率为负数的股票能买吗？	stock
中国最独特的公司，温氏究竟厉害在哪里？	news_finance
五胡乱华时期到底有多黑暗？	news_culture
为什么中国不能像美国针对华为手机一样也针对美国苹果手机禁售？	news_tech
如何判定一头公猪应该淘汰了？应当给予其四次证明自己的机会	news_agriculture
购房者应该怎样做才能买到称心如意的房产？	news_house
小学苏教版语文五年级下册每课一练生字词语句子课文内容专项练习	news_edu
为何日本自古以来一直想吞并中国？说出来你可别不信！	news_world
穷游一定要避开这个国家，出行打不到出租车，不预定连宾馆都没有	news_travel
5月5日美股低开高走，大涨将近400个点，对下周一A股走势有什么影响？	news_finance
中国中药协会灵芝专业委员会成立大会	news_finance
有什么比较公平的网络游戏吗？	news_game
底部放量是什么意思？	stock
支付宝又有重榜好消息，4.5亿用户终于迎来了春天	news_tech
四川游客张某带着六名女子在三亚沙滩烧烤被撒沙，这事你怎么看？	news_travel
芜湖购房最高可补贴200万元 再出人才新政	news_house
麦当劳开王者荣耀主题店了？可以开黑吗？	news_game
小学美术教师编好的书该怎样出版？	news_culture
游戏世界：吃鸡风潮将过，这个网站又推出一款吃鸡页游引腾讯注意	news_game
哪些大学的研究生院工程管理专业还可以？	news_edu
中国书法博大精深，见字如见人，是时候练练自己的字了	news_culture
如果给你三十万，你会选择什么车？	news_car
它是来自北京车展的一匹黑马，起售价八万！	news_car
莎士比亚名言精选（爱情篇）——以爱的名义靠近你	news_culture
王者荣耀：张大仙不敢打巅峰赛太菜？抱歉！巅峰赛已经到处是演员	news_game
和中国最友好的国家	news_world
南京六合区地铁口别墅！金牛湖嘉恒有山总价180万起！嘉恒有山	news_house
希特勒和拿破仑都在俄罗斯折戟沉沙，难道俄罗斯真的不可战胜吗？	news_world
黄埔一期入学纪念日，回看黄埔军校教学水平究竟怎样	news_edu
高考专业相同或者相近，院校应如何选择？	news_edu
联合国安理会改革废除一票否决权，会导致什么后果？	news_military
明星看自己演的电影电视剧是什么感觉呢？	news_entertainment
以色列警告称如果战机被击落将会轰炸俄军事基地，你怎么看？	news_military
叙利亚还要乱多久？俄罗斯：前景堪忧，美国实乃罪魁祸首	news_world
国足携手杰尼亚！里皮推选3小将前往罗马训练	news_sports
美国建国不过两百年，为什么会成为世界强国？	news_world
木匠外出干活，深夜归途遇鬼	news_story
售楼闺蜜告诉我，这几种户型的房子万万别买，后悔我家买错了	news_house
贵阳银行怎么样？	stock
玉笛吹来美人风，如何赐句？	news_culture
中金：中国CDR发行有望年中启动 龙头券商料受益	stock
哪个牌子的pos机比较好用？	news_tech
为什么现在中国平安、中国人寿和太平洋保险都在拼命招人？	stock
吃百香果，喝百香果汁不时髦啦！2018流行吃“香蕉百香果”	news_agriculture
别还蒙在鼓里！这4款SUV就是换壳面包车，最后1辆月均2万人入坑！	news_car
零基础学摄影，轻松考大学，聊城高二学生的机会来啦	news_edu
俄罗斯胜利日阅兵总彩排盛况 央视记者带你先睹为快	news_military
英国脱衣舞娘怀孕9月仍登台 脚踩10厘米高跟鞋	news_entertainment
日本茨城机场附近有什么能玩的地方么？	news_travel
谢娜粉丝过亿获吉尼斯认证 总裁大呼她为“谢大伽”	news_entertainment
180506 奶凶不是唯一标签 品味白侦探推理魅力爆发瞬间	news_entertainment
如果美国各个州独立了，世界格局会发生什么变化？	news_world
男团决赛，中德男乒大战，马龙兵不血刃3:0赢波尔，为国乒拿到开门红，如何看待？	news_sports
深市今日停复牌一览(5月7日）	news_finance
聊城故事：关羽阳谷斩郎屠，恶鬼惊扰姜家庄	news_story
GuruFocus创始人：股神接班人是今年最大亮点	news_finance
两个人投资开店其中一个人不管，利润该怎么分？	news_finance
旅行达人告诉你，旅行不管短途或是长途别忘了带这些，干净还卫生	news_travel
谢娜真的可以退圈了，粉丝过亿被催娃，产后迅速回归却被网友嫌	news_entertainment
A股各行业龙头股一览表，建议关注非常全面！	stock
18款雷克萨斯LX570 凌志王者促销爆惠	news_car
2018年随着二胎政策放开，三四线城市房价还在上涨，这两者有何关系，房价上涨的原因有哪些？	news_house
现在学什么专业好？	news_edu
余额宝升级后，有两只新的货币基金，分别是博时基金和中欧基金管理，对用户有什么风险吗？	news_finance
女人婚后的长相，恰恰说明了婚姻的幸福度	news_story
养老保险一次性补缴15年，60岁后每月可领1300元，你愿意交吗？	news_agriculture
ESI中国最新十大高校排行，第一名你也许不知道	news_edu
西藏一季度接待游客人次和总收入增长均超四成	news_travel
埃梅里：姆巴佩本来想去皇马或巴萨，但我劝住了他	news_sports
赵丽颖很久没有登上微博热搜了，但你们别急，她只是在憋大招而已	news_entertainment
一个月近900人死于枪击，拥枪对美国到底有什么意义？	news_military
特朗普为什么可以随意废除此前美国政府达成的各种协议？	news_world
全国人民喜迎油价上涨！	news_finance
如何与特朗普打交道？外交官：要夸他比奥巴马强	news_world
马上就高考了，怎么复习？	news_edu
2018年下半年的房价还会涨吗，何时入手是最佳时期？	news_house
轮胎侧壁出现裂纹有影响吗？	news_car
联通最便宜的全国不限流量套餐，今天真来了！	news_tech
机票攻略｜说走就走，你还差一张特价机票给你勇气	news_travel
1699的魅族m15和1268的魅族pro7标准版该选哪个？	news_tech
马栏山 马栏镇 马栏村 马栏坡的马小姐获两项吉尼斯世界纪录称号	news_entertainment
官人某牙事件再度升级！官人：欠我的钱不要了，高管敢回应我吗？	news_game
四川游客张某带着六名女子在三亚沙滩烧烤被撒沙，这事你怎么看？	news_travel
女星还债4亿，拿1亿现金买房，王珂追问：刘涛，你还有多少钱	news_entertainment
在农村读书的要注意了！	news_edu
怎么看待有人冒充马化腾回应《腾讯没有梦想》一文？	news_tech
特朗普只是一个商人，更是一个政治素人，美国如此发达的国家为什么会选其当总统？	news_world
黄土、黑土、红土哪一种土更适合农业发展？各自适合种植什么东西？	news_agriculture
美国参议员麦凯恩说他的葬礼上不请特朗普，大家怎么看？	news_world
2018年上证指数会跌破2638点吗？	stock
日本强硬向美说不，是真心还是作秀？	news_military
勇士全神贯注 2017-2018NBA 勇士VS鹈鹕	news_sports
大学生是考研好，还是考公务员好？	news_edu
宝马旅行车和奥迪AllLOAD旅行车保养会很麻烦吗？	news_car
从东京女留学生遇害案，说说清末为何喜欢扎堆留学日本？	news_edu
山海万宁——大洲岛	news_travel
马克思思想之光照进银幕荧屏	news_entertainment
上班族，25~30w之间选什么车比较好？	news_car
季莫申科目前民调支持率最高，她有机会成为下一任乌克兰总统吗，你怎么看？	news_world
他拍戏吓坏孙红雷，拍床戏吓坏对手，为照顾母亲放弃事业四年！	news_entertainment
你怎么看待以色列总理出席俄罗斯5月9日的阅兵并会晤普京？	news_military
股票分红又除权，股价下降，不就等于没分红吗？	stock
云联惠为什么会进博鳌论坛？	news_finance
当红女星的十八岁：迪丽热巴古力娜扎参加虞姬海选，范冰冰当丫鬟	news_entertainment
如果你是新手，想骑行西藏318国道，选择自行车应避免这几个雷区	news_travel
他大学毕业后逃离城市，隐居深山里过上了原始生活	news_story
止泻2小时见效就是这么简单，不信您试试！	news_agriculture
股票全天波动-1%左右，尾盘三分钟拉回，第二天低开，主力意图是吸筹还是洗盘？	stock
本想买卡罗拉的我，最后却提了这部suv，只因这车性价比太高了！	news_car
看过这个人的生活，你还有什么好抱怨的	news_story
特朗普为何称美国不想再当世界警察，只想管好自己？	news_world
流浪狗扰乱正常教学秩序，破坏学生们生活，该怎么办？	news_edu
为什么美国人一到18岁，马上会被父母赶出家门？	news_world
古代对女子的称呼有哪些？	news_culture
长江策略：4月陆股通大举净流入 全球资金或提前布局MSCI	stock
4岁女孩身高1.3米，全家人以此为荣，体检报告却让她们都崩溃	news_story
微信小程序开发需要用到哪些？	news_tech
月薪1.2万，房贷1500元，适合买什么车？	news_house
结婚不到一个月，你就让我把房子过户给你？没门！	news_story
东风21D的战略威慑究竟有多大？	news_military
上联：一片彩霞迎旭日，怎么对下联？	news_culture
马化腾回应《腾讯没有梦想》：我的理想不是赚多少钱，是做出最好的产品	news_tech
做棋牌游戏代理真的靠谱吗？	news_game
佛山有哪些地方可以游水？	news_travel
「四+六对联7」出句：笔尖纸薄，惯写人情世态；请您对句	news_culture
哪种软件适合成人学习英语？	news_edu
跨界歌王薛之谦穿着时尚亮相，唱了一首绅士，开口全场都沸沸扬扬	news_entertainment
农民在地里三件事情不能随意的做，不然可能会失去土地！	news_agriculture
护照有效期不足6个月能去普吉岛吗？	news_travel
我就不明白了，为什么发行完股票，还要再增发。那不是坑人吗？	stock
大连一方主场3-0击败广州恒大，取得中超首胜，他们取得胜利的原因是什么？	news_sports
《这就是街舞》真的有黑幕！从哪些地方可以看出？	news_entertainment
四川游客张某带着六名女子在三亚沙滩烧烤被撒沙，这事你怎么看？	news_travel
五月份果园该做哪些工作？（下）	news_agriculture
以色列警告称如果战机被击落将会轰炸俄军事基地，你怎么看？	news_military
猛龙主教练跟泰伦卢在这个系列赛的执教水平你怎么看？	news_sports
银行卡没有钱，如果一直不用，每年都扣年费等等费用，十年二十年后，银行会主动来要费用吗？	news_finance
买房最高补贴200万，50万安家补助！安徽这个市PK合肥人才新政！	news_house
带雨伞太麻烦，越来越多女人出门包里放个胶囊片，刮风下雨都不怕	news_travel
上联：田在心上思故乡，求下联？	news_culture
美国洛杉矶迪士尼乐园Disneyland一日游攻略	news_travel
以色列警告称如果战机被击落将会轰炸俄军事基地，你怎么看？	news_military
“脱贫摘帽快 特色产业带”——祁东县精准脱贫记	news_agriculture
如何评价满清八旗最后的名将——僧格林沁？	news_military
互粉有效性和原创收益实测分析，大家根据实际情况进行选择！	news_game
下周核心股票池：世界杯要来，最强最火的居然是只鸭脖概念股	news_finance
什么样的散户最让庄家头疼？	stock
你认识的高考严重超常发挥考入名校的人后来怎么样了？	news_edu
轿车突然冲向马路中央撞翻 路人打开车门救人却 傻眼了	news_car
MSI泰国战队再现“黑科技” 主教练竟带“武林秘籍”登场	news_game
次新股有望开启反弹行情吗？	stock
赴英旅游正当时 盘点英国游景点	news_travel
章泽天告诉我们：要想嫁得好，首先你得好！	news_tech
山东最新17市的房价出炉了！快看，你家房价的走向！是真高！	news_house
2天思维导图视频直播课+电子书+思维导图全套素材，全部免费送！	news_edu
车子安装了高速etc，并且绑定的是中行信用卡。现在车准备卖了，etc怎样处置？	news_finance
“国六”即将实施，常用的“国三”“国四”会怎样处理呢？	news_finance
俄罗斯、土耳其、伊朗同盟已成，美国会对埃尔多安动手吗？	news_world
NBA的三分谁最厉害？	news_sports
什么是方法论？怎么掌握方法论？	news_culture
农村承包地确权进入收尾阶段 确权面积已达11.59亿亩	news_agriculture
如果美国各个州独立了，世界格局会发生什么变化？	news_world
上联：猪不能没有毛，下联怎么对？	news_agriculture
旅行青蛙中国之旅什么时候上线 中国之旅上线时间一览	news_game
农村集市上这些的东西，真的是便宜又好吃，简直赚大了	news_travel
诸城市相州镇惠发小学强化学生感恩教育	news_edu
如果可以，让你从DNF的NPC中选择一个带来现实，你会选谁？	news_game
燕郊房价还会涨到调控前的水平吗？	news_house
猛龙VS骑士G3，詹姆斯绝杀的那一球，骑士队为什么不选择发前场球？	news_sports
想去哈尔滨凤凰山旅游，这个地方怎么样？	news_travel
小奶狗撩妹套路深，《北京女子图鉴》陈可“姐弟恋”再陷感情危机	news_entertainment
实体店根本买不到的9款车载小物，平时跑断腿都难买到，真好用	news_car
中国此无人机直接对标美国“死神”，现在功能更强大使用也更经济	news_military
农村老话“家有千万，带毛不算”当你明白道理，为时已晚！	news_agriculture
偶尔玩游戏，小米mix2续航怎么样？	news_tech
揭开日本艺伎的神秘面纱，渐行渐远的背影风光不再	news_world
做算法工程师是什么样的体验？	news_tech
OTT只能卖开机？酷开网络用活动让广告“玩”起来	news_tech
「学族教育」课辅品牌那么多，在线也有不少，到底哪家合适？	news_edu
聊城人快看！我们每天生活的聊城，原来是这个样子！	news_agriculture
紧急提醒！有工行、建行、农行卡的人，一定要看！	news_car
下联：饱暖思淫欲。请赐上联？	news_culture
海南房地产为什么会限购？	news_house
男乒世乒赛九连冠	news_sports
供电公司和农业银行共同牵头实施户用光伏	news_agriculture
小米就要港股上市了，那么为什么选择香港而没有选择上海？	stock
如何评价《盲山》这样的电影？	news_entertainment
如何找到一个指标能更好的了解多空双方力量强弱？	stock
“涨的不是房价，是货币发行量”这一说法是否有道理？	news_house
上联：月印荷塘荷印月，如何对下联？	news_culture
《水浒传》给我们展示了一个怎样的世界和怎样的世界观？	news_culture
成都首座高空玻璃栈道五一开放，在哪？	news_travel
凤凰旅游，如果不体验这个项目，那真算是白来了	news_travel
买了七座车之后，很多人后悔了！	news_car
如果刘国梁出国执教你是支持还是反对？	news_sports
交通银行东方航空信用卡申请难吗？白金卡比较难入手	news_finance
南海航空兵建设小目标——独立歼灭至少3个尼米兹战斗群！	news_military
为什么有的股票在大盘跌时它涨，在大盘涨时它反跌？	stock
研究称2035年广东GDP将超英法 人均近20万元	news_finance
现在多少人在做新三板？	stock
民间故事：黄鼠狼抽旱烟烧了洞府，四处蹭烟：戒了吧！	news_story
40岁的清洁工阿姨第一次化妆，妆后的她笑的很美，看完心酸！	news_story
上联：无可奈何花落去，下联怎么对？	news_culture
上联：柳乱池塘水，下联怎么对？	news_culture
叛军准备反扑，却遭遇俄军撒下白磷弹，俄罗斯斩获重大成果	news_military
叙利亚政府军从一处叛军据点缴获的武器里面有俄制的装备，你怎么看？	news_military
连续跌停的股票是谁在买入？	stock
有哪些偏冷门的歌曲推荐？	news_entertainment
巴以冲突千名巴勒斯坦人受伤 其中包括149名未成年人和8名妇女	news_world
90后小伙用区块链养鸡一年时间完成10万+会员认养吸引资本数千万	news_agriculture
想回农村开面店，有什么需要注意的吗？	news_agriculture
阆中嘉陵江两岸原生态自然风光，一个让人来了就不想离开的地方！	news_travel
针对违章电动车骑车人，让其观看一段时间事故图片及视频，会不会更有效？	news_car
「教资结构化」一个小孩说方言，其他学生不喜欢他怎么办？	news_edu
为什么洛伦兹速度变换方程可以推出光速是物体运动的极限速度？	news_edu
美国有飞机墓场，而乌克兰有坦克墓场，但境遇大不相同	news_military
农特产品怎么运用抖音营销？	news_tech
国际油价创近三年半新高 国内油价今日料“四连涨”	stock
现在在县城买房合适吗？	news_house
《演员的诞生》第二季确定暑期见，导师拟邀著名导演？	news_entertainment
以色列警告称如果战机被击落将会轰炸俄军事基地，你怎么看？	news_military
东京游玩8天，如何安排行程？	news_travel
他们将家猪丢弃在无人岛，几年之后，它们的生活竟是这样的！	news_travel
马云告诫以色列大学生：别介意出身，重要的是你做什么	news_tech
全年法定带薪节假日达28天！世界上假期最多的国家竟是它	news_world
喜欢吃水果，可以考虑在家里自己种点，好吃还方便	news_agriculture
机构调研聚焦环保板块	stock
贵州哪里有比较大的服装批发商铺？	news_travel
余额宝有可能发行自己的银联卡，建自己的取款机吗？	news_finance
毕业后怎么重新修读其他专业？	news_edu
茅台市值相当于多半个芯片业，暴露了什么问题？	stock
吉利新帝豪与长安新逸动xt哪个好？	news_car
骑士战胜猛龙拿到赛点，詹姆斯此项数据NBA第一，超过乔丹	news_sports
苹果6 10.5系统有必要升级到最新11的系统吗？	news_tech
上联：江山千古秀，怎么对下联？	news_culture
买美国哪种房子最赚钱？楼房别墅大比拼！｜小李抛砖	news_house
5步计划开始你的演艺事业	news_entertainment
张家口楼盘活力城超5A写字楼助你赢天下！	news_house
日本向中国提供半导体技术，是帮助中国对抗“科技战”还是其他？	news_tech
“科摩多-2018”多国联合演习开幕	news_military
本人开火锅店，想加入麻辣小龙虾，哪里有小龙虾养殖基地？	news_agriculture
药明康德登陆A股 CRO行业迎巨头	stock
被大多数人忽略的买房好处，我猜你没有想到！	news_finance
到底娱乐圈有多难混？	news_entertainment
索泰杯第二日QM吃两鸡引发争议？虎扑大神扒出QM违规行为？	news_game
情报站｜在济南饮一碗“大碗茶”惬意舒适！	news_travel
农村俗话“斗米养恩，担米养仇”应该怎样理解？	news_agriculture
Fullestop调研VR技术在不同行业都存在影响力	news_tech
故事：不小心挖到的一具女尸，济爷却是吓坏了	news_story
农村人常常吃的野菜，在专家眼里还有这样的功效！	news_agriculture
9轮4球本土射手仅次武磊 黄紫昌要抢最强U23头衔	news_sports
梦幻西游：掉须弥只是逆袭的开始？喜闻乐见的结局	news_game
开始种植水稻了，秧田播种时，如何进行地膜保温育秧？	news_agriculture
如果所有银行不让支付宝绑定银行卡了，支付宝会怎样？	news_tech
如何在商业活动中不受人欺骗？	news_sports
读老报：99年肯尼迪二世坠亡事件，肯尼迪这个家族总出大事情	news_world
现在王者荣耀都禁哪些英雄？	news_game
以色列宣称有秘密文件证明伊朗在核协议方面撒谎，你认为有多高可信度？	news_world
国产手机那么好，为什么还会有这么多人用苹果手机？	news_tech
职业操盘手不可外传的成交量买卖精髓，字字珠玑！	news_finance
立夏后的农事概要，农民朋友们必须知道	news_agriculture
坐着火车去拉萨，原来是这样的体验……	news_travel
蔡依林被“完美女神”提问质疑已经过气，她的心态赢得全场喝彩	news_entertainment
乐视网复牌股价下跌，孙宏斌输了吗？	stock
印度的这些习俗中，除了左手上厕所外，还有这个习俗我理解不了	news_world
苏州大学和东北财经大学哪个研究好？	news_edu
如果把500万人民币存进银行，光靠利息能过上什么样的日子？	news_finance
如果禁止未成年人充值腾讯游戏，腾讯营收会受到多大影响？	news_game
上联：山水醉人何须酒。如何对下联？	news_culture
如果发达国家都在非洲，其他地区都是发展中国家的话，我们的审美是否会趋向认为黑种人比黄、白人种好看？	news_world
军装承载荣耀 时刻践行标准	news_military
上联：梦里水边情，回味绵长，下联怎么对？	news_culture
我想买探界者，探界者和昂科威一样的轴吗？	news_tech
下联：饱暖思淫欲。请赐上联？	news_culture
孙艺珍也救不了《经常请吃饭的漂亮姐姐》的剧情，已打算弃剧？	news_entertainment
市值与业绩倒挂，华大基因是第二个乐视网吗？	stock
夕阳无语燕归愁，如何接下句？	news_culture
为什么西方国家不直接空袭叙利亚总统府，是怕吗？	news_military
主力是怎么建仓的？要怎么样可以看出来？	stock
《荒野行动》90%的人都不知道的钻石获取方式！不用太浪费了	news_game
MSCI成分股即将敲定 A股迎来新动能	stock
德罗巴解密助攻秘诀：我喝了球童的圣水	news_sports
谁在说股市慢牛？	stock
仅仅7万，标配胎压监测，比哈弗H6还漂亮	news_car
盘中突然跳水，是什么原因？	stock
英拉去哪里了？	news_world
为什么在《复仇者联盟3》中地球的军方没有参战？	news_entertainment
为什么这么多年阿富汗总是战乱不断？	news_military
普京视察时橘猫“小桥”抢镜，背后故事暖心	news_world
定个小目标？巴萨盼保不败+挫皇马锐气 助梅西争欧洲金靴	news_sports
180506 网友造谣李易峰所乘车辆撞人 川影发布说明澄清	news_entertainment
教育的分类有哪些？	news_edu
盘点全球十大速度最快的 飞机	news_military
手机天气软件哪个最好？	news_tech
为什么现在股票大盘3300多点了，但是我所关注的大多数股票会比去年2800多点时还低？	stock
美人美景美时节，下一句怎么接？	news_travel
希尔顿资本：美国大银行回购股票之举不明智，看好小银行股票	stock
S11最强射手排名！第一名却只需2888金币？触手蓝烟用来打王者局	news_game
中国游客在巴基斯坦很受欢迎，如同贵宾，但这个方面很严格	news_world
一夜之间，芝麻分更新，7亿支付宝用户沸腾，你芝麻分涨了多少？	news_tech
同样懒精上身群众却只喷张杰不喷他，这是双标吗？	news_entertainment
主帅1言恐让德罗赞开启暴走？2数据扎心，绝境的他平平无奇！	news_sports
黄杨木是什么树？	news_culture
加沙发生爆炸致死6人	news_world
71岁施瓦辛格露面，跟小女友穿情侣装，心脏手术后走路迟缓	news_entertainment
詹姆斯8秒绝杀猛龙，洛瑞表情呆滞含有泪花，你怎么看？	news_sports
热刺作死的节奏！连垫底队都输，欧冠席位悬了？	news_sports
一个创业成功的项目，是这样做的	news_finance
不上进的男人，有怎样的圈子	news_story
世乒赛男团决赛，中国队3-0完胜德国，两队的排兵布阵有哪些亮点和失误？	news_sports
因抖音爆红的六大景区，你去过几个？网友：越红越不要去	news_travel
奥拉朱旺远赴盐湖城为火箭队加油助威，你如何评价？	news_sports
全球最老鹦鹉，享年55岁，终前对女主说俩字让她瞬间变成泪人！	news_story
以后房子会越来越便宜，还是会越来越贵？	news_house
你有哪些在外地求学/工作不会轻易向别人提起的心酸生活？	news_edu
超级替补！科斯塔本赛季替补出场贡献7次助攻	news_sports
三明贵溪洋拟建服务型公寓，共300多套！附市区5月份二手房价	news_house
如果所有银行不让支付宝绑定银行卡了，支付宝会怎样？	news_tech
作为一个高三学生的家长，为孩子的高考志愿填报，现在应该做什么？	news_edu
取消农业户口对农民有哪些好处？	news_agriculture
2018陆家嘴金融城足球联赛昨天拉开帷幕	news_sports
杨振宁说：把中学生送到美国读书非常危险，你怎么评价？	news_edu
来四川旅游必去的八大景点	news_travel
《战狼2》中吴京用铁丝板档火箭弹，这在现实中可能吗？	news_military
重庆游玩有哪些旅游攻略？	news_travel
美国法院判伊朗赔付9·11遇难者家属逾60亿美元，你怎么看？	news_world
上证为什么叫综合指数，深圳叫成份指数？	stock
人人都承认房价存在泡沫，但为什么没人敢说房价下跌？	news_house
2年0息丨“万元”五重礼WEY你而来	news_car
《天乩战之白蛇传说》赵雅芝和杨紫饰演母女会擦出什么样的火花？	news_entertainment
四冲程摩托车发动机可以用来做油直吗？	news_car
科普：使用微信付钱，这两个安全功能一定要打开，不然后悔！	news_tech
四川游客张某带着六名女子在三亚沙滩烧烤被撒沙，这事你怎么看？	news_travel
家里有两个女儿，父亲不愿意买房子是什么心理？	news_house
国产suv哪个品牌有底盘研发能力？	news_car
索尼哪一款手机最好用？	news_tech
美国参议员麦凯恩说他的葬礼上不请特朗普，大家怎么看？	news_world
有些股票前一天涨停，后一天就跌停，都是主力所为吗？主力看样子亏了呀？	stock
女婿拍马屁（幽默故事）	news_story
今日就教大家复原魔方的方法	news_edu
“废品”变“珍品” 村民进城看展品 后悔家里的老物件当废品丢弃	news_agriculture
有什么高逼格的微信名字？	news_tech
「热点」高速上女司机突然的一个举动，一条命没了！4成事故皆因此发生！	news_car
一季度广州商品房销售面积同比现“腰斩”	news_house
坟墓里钻出的黄皮子最恐怖：有人许愿得了个老婆	news_story
故宫断虹桥那只“护档狮”有什么来历？	news_culture
水墨石林——甘肃景泰石林美景	news_travel
球队开心果！火箭官方晒周琦为塔克唱生日歌视频：真奇妙	news_sports
6日热点新闻：可口可乐日本又出新品，可以冻起来吸着喝	news_game
初三的学生马上就要面临中考，有什么好的学习方法推荐吗？	news_edu
有人说日本要是不参与第二次世界大战，现在世界上最强大的国家非日本莫属，你怎么看？	news_military
如果日本国土滑向海沟沉没，要求中国人民收留，作为中国人你会接受日本人吗？	news_world
中国与越南边界	news_world
浦口火车站的沧桑记忆	news_travel
月薪5000元在北京是什么样的水平？	news_story
中国收入最高的球星：三度结婚终娶小17岁女友，被誉为足球领袖	news_sports
要是乐视股票开盘后没人接盘，那会是怎样的局面？	stock
12天10个涨停！华锋股份成妖背后：深圳佛山一线游资连炒	stock
倪妮：优雅大方	news_entertainment
彩礼重，娶妻难！超3000万光棍被判“无妻徒刑”？别急，专家帮您	news_agriculture
会奖旅游之会议酒店推荐：上海璞丽酒店	news_travel
《荒野大镖客2》发售前全方位情报汇总，都是各位想知道的！	news_game
古代的状元放到现在是不是大学生？	news_culture
为什么说以后的城市空房会越来越多？	news_house
长老告诉他一个秘密后大富，半仙却说他富不过三年，还要穷三代！	news_story
2200荣耀V10与2599荣耀10应该怎么选？	news_tech
追涨杀跌是炒股的大忌吗？	stock
我的世界，奶块，迷你世界，泰拉瑞亚，麦块哪个更好？	news_game
游戏剧情里有哪些令人拍案叫绝的「智障桥段」？	news_game
美国没有装备仿制的MG42机枪吗，为什么？	news_military
四月武汉最受关注度的20个楼盘出炉！大光谷片区上榜最多！	news_house
刘诗雯在世乒赛女团决赛的表现如何？	news_sports
新一代车载逆变器来袭，你的移动发电站，出门用电就是这么简单	news_car
准研究生从现在到开学这段时间做些什么来赚点钱呢？	news_edu
预算15万左右，vv5、马自达cx4和名爵6相比，哪个比较好？	news_car
「人人车」女汉子买16款路虎-揽胜极光，30万入手，霸气测漏吧	news_car
“两微一抖”成标配？看房企如何玩转抖音	news_house
找工作要学历,学历等于能力吗？	news_edu
2017款福特猛禽F150 白金版顶配夏季爆款	news_car
为何看到2018NBA季后赛勇士VS鹈鹕G3，勇士球迷称勇士是在放水？	news_sports
子弹肌展示	news_military
世界第一伟人是谁？	news_travel
LOL哪个区玩家最有素质？	news_game
肥沃的近义词是什么？	news_edu
长时间震颤会怎么样？	news_car
中国芯片第一龙头，横盘2年底部现金叉，5月或超京东方A	news_finance
从遭人嫌弃到最具黑马潜质！这款SUV终于要翻身了	news_car
二战时候的日本轰炸机一次带多少炸弹？	news_military
搞艺术的人有什么共性？	news_culture
塞班军舰岛：一个无数比基尼美女扎堆的海岛，搞不好还可以艳遇哦	news_travel
首家军工科研院所转制获批鼓舞板块人气 11只绩优军工股吸金逾2亿元	stock
天龙八部手游：华山论剑特殊战法就在这里！	news_game
为啥一根破烂的金丝楠木能值2000万？	news_culture
对越反击战打草惊蛇战术妙，坑死越军1个加强排	news_military
长沙张公岭考场「科目三」直线行驶6大秘籍—恒哥话驾陪	news_car
农村集市上的垃圾桶真的可以卫星定位吗？	news_agriculture
途观L和x1，哪个好？	news_car
历史上的十大军事人才有谁？	news_military
下联:夕陽西下已黄昏。上联是什麽？	news_culture
如何应对加密货币的崩溃？	news_finance
涨价之前买房的人，现在是什么心情？	news_house
股票抄底者死是真的吗？	stock
关于要不要买房？	news_house
陕西煤业：业绩平稳增长 低估值优质动力煤公司	stock
痴鸡小队的呆鸡有多坑？	news_game
还能这样操作？停车被贴罚单！车主：我是停在自己家门口！	news_car
以色列警告称如果战机被击落将会轰炸俄军事基地，你怎么看？	news_military
同学聚会，一对都有家庭的男女的聊天记录，真是打脸！	news_story
1699的魅族m15和1268的魅族pro7标准版该选哪个？	news_tech
以色列竟强逼俄罗斯报恩！原来是为打伊朗扫清障碍	news_world
上联，绿竹引清风，如何对下联？	news_culture
如何评价：刘姝威的《严惩做空中国股市者》？	stock
特朗普只是一个商人，更是一个政治素人，美国如此发达的国家为什么会选其当总统？	news_world
社保基金新进增持了哪些股票？	stock
中国最变幻莫测的公路：积雪比车高，一会下雨，一会下雪	news_travel
火爆的楼市现状，刚需最后的上车机会？	news_house
你有这样停过电瓶车吗？我这样停车差点失去生命	news_story
为什么叙利亚40个反对派同时反对俄罗斯主导的和谈？	news_military
全域体育助力全域旅游 全民健身助推大健康产业	news_travel
冷门好碑帖06：谢安行书手札，东晋超级男神的书迹	news_culture
2018年随着二胎政策放开，三四线城市房价还在上涨，这两者有何关系，房价上涨的原因有哪些？	news_house
高数难学吗？	news_edu
幸福多一种选择——宋MAX 6座华中区星级上市 售价7.99万元起	news_car
古老神秘的乌公侗寨竹米节，一家蒸竹米饭全寨香，你想尝尝吗？	news_agriculture
小米7支持5G吗？	news_tech
为什么国人能接受并喜欢石川佳纯，但不怎么喜欢张本智和？	news_sports
5月10日起，德州开发区这个路口开始抓拍“不礼让斑马线”！	news_car
以色列警告称如果战机被击落将会轰炸俄军事基地，你怎么看？	news_military
你会念这四个单词么？鸿鹄之志，莘莘学子，乳臭未干，谆谆教诲	news_edu
往海中投一枚原子弹会发生什么现象？	news_military
西安房价会涨过2万的均价么，如果跌的话还能跌回原来的6千么？	news_house
师徒之争 舒斯特尔给卡纳瓦罗上了一课	news_sports
红米note5待机一晚耗电10%正常吗？	news_tech
5月6日股市内参	news_finance
盘点漫威电影人气最高10位女主角：黑寡妇排第10 第一名是她	news_entertainment
稻种有缺陷水稻大减产	news_agriculture
下跌放量好还是缩量好？	stock
如何在社会中成长？	news_culture
互联侃谈：霍官泰和他的楼花，房地产的行业，到底有多深？	news_house
能视频通话，能人脸识别，能语音拍照的8英寸智能音箱	news_tech
我的世界有多少个遗迹？种子是什么？	news_game
掏蛇记（现代故事）	news_story
关于走阴的真实故事	news_story
《创造101》黄子韬battle王一博，你更喜欢谁？	news_entertainment
如果我要在二级市场大量买入乐视股票，除了准备大量资金，还要准备什么？	stock
西安小升初电脑摇号加面试，要不要报面试培训班？	news_edu
为什么果树旺长不结果？为什么果树结果很少？如何改造成高产树？	news_agriculture
石家庄买房可以买样板房吗？样板房到底能不能买？	news_house
安徽证监局协调下 杭州银行扣划2.11亿元募资款已全额归还江南化	stock
陈小春一家三口重游结婚旧地，Jasper玩的非常开心，太可爱了！	news_entertainment
6座MPV车型宝骏360，起价5万，家用车市场的首选！	news_car
俄罗斯在普京之后是否有可能再次发生解体？	news_world
中国农科院集成创新推出蔬菜绿色生产“4H”模式	news_agriculture
同学父亲去世我给五百，一月后我婆婆去世他的表现让我心寒！	news_story
为什么行尸走肉不能看了？	news_entertainment
周一大盘机会难得不突破就创新低	news_finance
暂停期间隆多亲身向浓眉哥示范如何在内线单打，队友们看着不说话直点头，你怎么看？	news_sports
活动预告l 资管新规解读暨债市投资策略会	news_finance
昆明做房地产销售的前途可以吗？	news_house
小米max2和红米5p，哪个好一点？	news_tech
98K和SKS的子弹初速哪个快？	news_military
明星拍戏避暑方法，鹿晗用风扇，赵丽颖吃冰棍，她却被骂耍大牌！	news_entertainment
*ST保千业绩大变脸，股市乱象谁来治？	stock
绝杀！詹姆斯38+7再创传奇一刻，两护法创另类神迹更功不可没	news_sports
中国股市常被股民骂，为什么？	news_finance
以后会有可能用无人机代替现在民航机吗？	news_tech
去云南的话，忘记大理和丽江吧，这个地方才是云南真正的世外桃源	news_travel
一旦房子价格暴跌，我们会面对怎样的场景？	news_house
日本地铁为什么没有安检？	news_world
张靓颖自曝右耳间歇性失聪，演唱会上五字讲述未来让无数粉丝落泪	news_entertainment
丰子恺：艺术家对世间万物都要予以热诚的同情	news_culture
俄将举行庆祝卫国战争胜利日阅兵活动，在彩排时它们也来凑热闹	news_world
上联：叹人生苦短，今宵难眠。下联怎么对？	news_culture
《瓦尔特保卫萨拉热窝》里的“劳费尔行动计划”是个什么计划？	news_edu
珠海国际会展中心斩获行业大奖 推动珠海市会展旅游产业加快发展	news_travel
一个人坐邮轮旅游有意思吗？	news_travel
国内哪一家航空公司的飞机餐最好吃？	news_travel
明星跌倒哪家强？范冰冰有人扶，奚梦瑶微笑，就服张韶涵的腾空飞	news_entertainment
盘点那些年你一定玩过的的经典游戏，钻石恒久远，经典永流传！	news_game
如果从江西高校中挑选5所很好的大学，你会如何挑选？	news_edu
绝地求生后座加强导致无法压枪，同时关闭个人交易系统，对此你怎么看？	news_game
村里家家都有小洋房，原来全是人贩子，五年后报应来了	news_story
为什么炒股不能满仓买入卖出呢？	stock
发现贵州之美，尽情享受，难以忘怀	news_travel
资金净流出为什么会涨停？	stock
高考只剩一个月，应该怎样复习？	news_edu
cba历史上最差的小外援是谁？	news_sports
雄风不再：俄罗斯图-22M轰炸机群已现旧态	news_military
重庆彩色马赛克“梯田”吸引游人	news_travel
吴宣仪是孟美岐的小公主 李子璇受《创造101》剪辑偏爱	news_entertainment
2018瑞典世乒赛男团半决赛，中国队3-0轻松取胜，如何评价三位球员的表现？	news_sports
路人局无解的阿珂，为何在KPL无人问津？梦泪亲自告诉你答案！	news_game
官方：里贝里与拜仁续约一年	news_sports
专家点评2018年高中学业水平考物理等级考试卷（附参考答案回	news_edu
如何才把白粉虱、蓟马和红蜘蛛一网打尽？	news_agriculture
盐城哪里最好玩？	news_travel
小米发烧，新品生为竞技，6G+64G+4000mAh+液冷，黄牛加价1000	news_game
西南大学的师范专业在师范类排在什么位置？	news_edu
网传《马卡报》披露，内马尔希望加盟皇马搭档C罗，可能性有多大？	news_sports
男大避母，女大避父，做父母在孩子面前定要言行谨慎	news_story
对越反击战打草惊蛇战术妙，坑死越军1个加强排	news_military
房子十年后会涨十倍吗？	news_house
这是字吗？简直是一件艺术品，看着就很舒服，真让人羡慕	news_culture
山西很多大学生又开始因为考研还是就业纠结，本科生毕业该如何抉择？	news_edu
寻找能成为核心的科技题材	stock
智慧农业大棚监控系统能实现哪些功能？	news_tech
那些经营不善而遗憾关服的手游之一 乐元素《梅露可物语》	news_game
什么是超写实绘画？	news_culture
国外最想买的中国武器装备是哪些？	news_military
什么品牌的矮壮素能防止玉米倒伏？使用防倒剂对玉米有何影响？	news_agriculture
太古，请赐联？	news_culture
调控严厉归严厉，土地买卖还是“马照跑、舞照跳”	news_house
你心目中的伟人是谁？	news_culture
魅族手机这个功能就值300块，刚买手机就要学会，否则手机白买了	news_tech
火葬场对面，有一栋公寓，这栋公寓晚上喧嚣热闹，白天死寂无声	news_story
回顾LSPL比赛！让帝被Khan爆锤，才明白FW前教练之前说的话	news_game
一个城市的发展靠的是什么？	news_house
这些城市，正在拿命欢迎你	news_house
3月房价下跌6元后 深圳4月跌16元又把大家逗笑了	news_house
美国又栽个跟头！叙利亚化武袭击新进展：这个秘密组织成替罪羊！	news_world
联想被踢出恒生指数，是什么导致了联想现在的这种境地？	news_tech
这是长沙最难脱单的一所学校，没有人不服！	news_edu
正是这几点原因，使得美国牛肉如此便宜	news_agriculture
怎么样判断一只股票是否有庄家锁筹？	stock
报名｜界面资本论坛热点前瞻：各界共议“创造可持续价值”	news_finance
林徽因为什么对金岳霖产生互爱？	news_culture
18款大众凯路威2.0T 商务豪车底价惠全国	news_car
女排欧冠半决赛，瓦基弗银行3:2险胜科内利亚诺，你怎么看？	news_sports
大货车的上的90后美女司机，行程几十万令人佩服！	news_car
老婆月薪4000多点，我8000左右，两个孩子幼儿园，房子没有压力，想买台迈腾，能不能养得起？	news_car
王者荣耀怎么看双Q大战，以XQ拒绝横扫3:1复仇QGhappy？	news_game
2018年高考时间确定！看2017年全国各省各批次录取分数线汇总！	news_edu
苹果创新高 道指连涨六日 10年期美债收益率跌破3%	stock
新三板无人机业绩“起飞” 行业应用全面开花	stock
印度大叔来到中国后很震撼，在中国平常的事情在印度是不可思议的	news_world
邓超母校这么多？现场瞬间变身国际学霸超 却遭陈赫无情补刀	news_entertainment
女子随手拍死一只蚊子，却为此付出惨痛代价	news_story
温暖龙岩之龙院前身一	news_edu
PS利用滤镜制作立体文字	news_tech
荆门长龙中央公园建小学是真的吗？	news_house
DNF 天御不闪了接着闪魔战 这两四等一深渊闪的俺们真给跪了	news_game
A股短期内会跌回2638点附近吗？	stock
中国发展得有多快，你知道吗	news_agriculture
为什么好多人都说儒家思想祸害中国？	news_culture
现在的职业学校能真正学到技术吗？	news_edu
西方制裁俄罗斯，俄罗斯靠什么撑了这么久？	news_military
郑州房产中介到底有多坑爹？	news_house
猛龙惨败骑士真因曝光！两错误让詹姆斯上演绝杀，这锅凯西得背！	news_sports
如何看待MSCI在六月份正式启动？	stock
有哪些文学霸气句子？	news_culture
如果腾讯不再免费，QQ和微信月租50元，中国还会有多少人继续用？	news_tech
故事：爷爷去世半年，五岁孙子指着一棵树喊爷爷，不久惊喜来了	news_story
CR929大飞机俄总师：没有我们帮助，中国造不出质量高的大客机	news_world
贵州省首个以脱贫攻坚投资基金支持的水利合规性项目获审查通过	news_agriculture
炒股的最高境界是什么？	stock
一战末期，列宁不惜割让大片国土求和，是否合理？	news_world
为什么在我们的观念里，外星人的科技一定会强过人类？	news_tech
王者荣耀中这些情侣CP，你觉得哪对最虐汪？	news_game
国画山水，如何读懂山水画	news_culture
冲刺2018年高考数学，典型例题分析63：客观题选讲，提高基础分	news_edu
一斤两块五的青菜人都买的吃，为什么两块五的股票没人买呢？	news_finance
5月5日绝地求生天命杯4AM战队成绩不理想，你怎么看？	news_game
你如何看待央视盛赞支付宝？	news_tech
世界第一伟人是谁？	news_travel
故事：黄鼠狼有灵性，报复老农民	news_story
高山滑雪危险吗？怎么看经常有人摔出赛道？	news_sports
绝地求生：近日爆料即将新增北极地图，那些吃鸡神器直接废了！	news_game
房地产四大龙头企业销售榜单出来了，碧桂园强势登顶	news_house
利希施泰纳宣布赛季结束后离队：我需要新的挑战	news_sports
为什么大学的程序设计老师不去外面公司做程序员？	news_tech
马云为什么不收清华大学生，他的回答让每个企业家深思	news_tech
投资期限对资产配置的影响	news_finance
为什么电影《倩女幽魂》中燕赤霞一个道士却拿着金刚经？	news_culture
全自动炒币机器人CCR炒币软件原理介绍	news_finance
抢房的新西安人	news_house
未来有一半工作被取代，文科生最吃香！李开复给父母们的3个建议	news_tech
连续29个跌停刷新A股记录的ST保千里打开跌停，可否抄底？	news_finance
故事：她经营了这家鬼店数百年，为人除灵解惑，来了一个暴发户	news_story
2019最火的豪车，发布一个月订单超37万辆，仅22万比奔驰C级帅！	news_car
美国人抱怨：“为什么美国没有普及手机支付？瞧瞧人家中国！”	news_tech
昆明附近二十年的老牌烧烤，每天夜色降临，已停满200辆汽车	news_car
看完印度最有钱的村庄，再看中国最有钱的村庄，对比一个天一个地	news_world
婆媳俩大年初二的聊天记录，看完好暖心	news_story
就业对接直入校园 广州大学城创新招聘会吸引过千人参加	news_edu
小轿车底盘生锈怎么办？教你一个好方法，5分钟除锈还防刮花	news_car
金融危机后什么最值钱？	stock
马思纯出席活动，网友：天啊，她俩怎么就亲上了	news_entertainment
物业公司的服务水准非常烂，该怎么解决？	news_house
谁有好的微信头像可以分享？	news_tech
郭跃在社交平台上说丁宁，每次输掉比赛都说受伤，对此你怎么看？	news_sports
金融术语：什么是认沽期权？	stock
股市交易出现0股市，这是什么意思？	stock
铁路类大专哪家强？	news_edu
谁再劝你先别买房，就把这10条狠狠甩他脸上！	news_house
战斗形态！新款野马5月底上市，或搭载10速变速箱！	news_car
勐景来，在拍完“爸爸去哪儿了3”后，如何做到持续吸引全国游客？	news_travel
美增加关税，为何人民币不降反升？	news_finance
小米上市后市值若超过百度，会带来哪些影响？	news_tech
余额宝升级了，有什么不一样？	news_finance
警惕农业天价传销	news_agriculture
10元人民币，斯里兰卡一顿饭吃不完，中国一顿饭吃不饱	news_travel
无人机直接撞向美航母 这国凶狠手段连俄罗斯都自愧不如	news_military
叙利亚政府军从一处叛军据点缴获的武器里面有俄制的装备，你怎么看？	news_military
会龙二字作一对联，最好将二字分别放在上下联的头一字，如何作？	news_culture
青山绿水依然在，下联如何对？	news_travel
玉米到底用不用追肥？怎样做更高产？专家为你解惑	news_agriculture
上联:今日头条，头条今日，说今日头头是道，论头条条条精华；如何对下联？	news_culture
上联：雨淋荷花荷更洁，怎么对下联？	news_culture
网上的借贷可以用吗？	news_tech
天美的五个亲儿子，皮肤很多很炫酷，可惜当前版本完全被抛弃！	news_game
2018国考跟省考同时入面试怎么办呢？	news_edu
如果日本国土滑向海沟沉没，要求中国人民收留，作为中国人你会接受日本人吗？	news_world
打仗时，战士们为什么宁愿被俘也不敢躺下装死，其实原因很简单	news_story
新手应该如何系统学习投资？	news_finance
目前分析哲学的前沿研究内容是什么？	news_tech
10个信用卡逾期46万，但每月多多少少都在还，会被报警抓吗？	news_finance
午餐要吃好，荤素搭配不能少，这菜我看着很喜欢！	news_agriculture
5月上中旬，小麦要高产还需怎么样管理？选择什么药剂？	news_agriculture
对越反击战，他1人毙敌18人，同事与他相处10年，才知他真实身份	news_military
白癜风可以吃虾皮吗？	news_entertainment
手游哪些最好玩？	news_game
买房的时候五证不全，该怎么办？	news_house
我们A股市场未来的三年十倍股，会出现在哪一个行业？	stock
宜春发展前景怎样？	news_edu
芜湖再出人才新政 购房最高可补贴200万元	news_house
假如日本沉没，日本冲绳人迀移中国你会接爱吗？	news_world
央视曝光：中国研制成功下代超隐身材料！美国：将领先美国一代！	news_military
埃梅里：全队在帮内马尔适应巴黎	news_sports
当好奔小康的“主心骨”	news_agriculture
特朗普跟里根有可比性吗？	news_culture
英冠第二支冲超队：百年名队重返英超，刘德华舅舅被骂4年终得正名	news_sports
外资来了，对哪类股票最有利？	stock
英汉句子：这个世界，没有偶然	news_edu
蜂群失王后，工蜂还会采蜜吗？	news_agriculture
名为房地产合作开发实为用地补偿合同的处理	news_house
一支股票卖盘一直挂豹子单，有何用意？	stock
2000左右买什么手机？	news_game
惠若琪被问女排中素颜谁最美，她机智地回答郎平，你怎么看？	news_sports
美媒：003型航母已开工，装国宝科学家颠覆性成果，改变游戏规则	news_military
贷款买房要趁早！下月利率有望迎来“16连涨”	news_house
为什么一定要做个善良的人？	news_culture
碧生源(00926)拟溢价9.89%发行2.93亿股予Aurum Credo募资1.46亿港元	news_finance
以色列警告称如果战机被击落将会轰炸俄军事基地，你怎么看？	news_military
三进制计算机可以实现吗？	news_tech
为什么明明公司业绩很好股票还是要跌？	stock
吴亦凡出席活动和某女星互动，网友：看他们的坐姿好像很不自在	news_entertainment
采暖季钢铁限产，带火了哪些上市公司？	stock
iphone6plus还能用几年？	news_tech
《跑男》请谁也不会请她们！这三位女星，其中有位请来会太尴尬！	news_entertainment
专家视点：“优质小麦面积上升，未来小麦价格发展如何”？	news_agriculture
一组清代光绪年间的壁画	news_culture
哪位退休的教师领到百分之百退休金？	news_world
为什么新股主力资金进入可次日股价下跌？	stock
农村灵异故事：村会计不听劝杀死一只狐狸，不久便遭了殃	news_story
人民币兑美元中间价报6.3524元 上调244个基点	stock
《绝地求生刺激战场》跑毒遭遇轰炸区是应该进房子，还是照常前进？	news_entertainment
日照市进一步优化完善农机购置补贴政策	news_agriculture
结婚十年公婆想全款买一套房子写他儿子的名字，生活中如果发生意外，妻子能分这套房吗？	news_house
农村老人常说的叫魂是真是假	news_story
他曾红过释小龙，误入歧途坐牢10年，如今洗心革面重新做人！	news_entertainment
中国为什么不鼓励混合动力汽车？	news_tech
幽鹤公园，加拿大国家公园中以壮观著称的一个，面积不大风景极好	news_travel
中国最美大学排行榜，这两所学校远超北京大学	news_travel
手机电量显示100%，突然自动关机显示没电了，是什么原因？	news_tech
做中国巴菲特系列之 涨停板环境研究（私募内幕）	news_finance
在深圳，作为有钱人是一种什么样的体验？	news_house
易建联接班人晒邀请函 秀警句激励自己不忘初心	news_sports
中国第一水乡，周庄	news_travel
新买的iPhone7自带的地图里面为什么会有莫名其妙的导航记录？	news_travel
农村集市上的鱼，新鲜又便宜，白鲢是做麻辣鱼的最佳选择	news_agriculture
现在农村人为什么都不种地了？	news_agriculture
以色列警告称如果战机被击落将会轰炸俄军事基地，你怎么看？	news_military
为什么很多女孩喜欢嫁非洲黑人？	news_world
2018世界杯有哪些强队缺席？	news_sports
腾讯没有梦想	news_tech
俄罗斯要找中国帮忙？和辽宁舰有关，你觉得该同意吗？	news_military
水泥钢筋价格大幅度的上涨，农村自建房怎么办？	news_agriculture
今天，马云入局，房地产行业将迎来毁灭性洗牌！	news_house
咸阳的袁家村到底是一个什么样的地方？	news_travel
教师通宵批改试卷猝死家中，其妻申请工伤或法院支持告诉我们什么	news_edu
同为2.0t的VV5和RX5该怎么选？哪款性价比高？	news_car
25届北京大学生电影节闭幕式，芳华演员钟楚曦、苗苗获最佳新人奖	news_entertainment
践行“军民融合”，助力“一带一路”	news_finance
这种花太好养活了！2个月长满阳台，庭院变花海，拦都拦不住！	news_agriculture
学习马克思斗争精神：主义真，同志以奋斗不止	news_edu
如果把明星整成网红会是什么样？	news_entertainment
王者荣耀各位置开局应如何处理更为合理？	news_game
二手房中介法人代表卷款跑了怎么办？	news_house
老婆，你回来吧！那样的钱咱们不挣也罢	news_story
CR-V直接放弃！本田祭出高颜值小型SUV配四驱，直接抢宝骏510蛋糕	news_car
为什么战列舰不采用自动装弹，像机枪那样的装置？难办到，不靠谱	news_military
鸡农药中毒后，有什么好的解救方法？	news_agriculture
学霸晒成绩 女神晒自拍 土豪晒有钱 模特晒身材 我晒太阳	news_entertainment
中国航母舰载机可以对抗F-22？这个改型有料了	news_military
夏日高温来，车内烫的如火烧身！装冰丝坐垫，开车出行凉爽又舒适	news_car
警告！夏威夷火山正在向空中喷射熔岩和“极高水平的危险气体”	news_world
上联：墙上画马不能骑，怎么对下联？	news_culture
上证指数持续围绕3100点震荡，是筑底还是持续下跌？	news_finance
养鸽子培育鸽子做种和参赛的区别	news_agriculture
父亲带儿子进深山过原始日子，穿树皮的45岁儿子竟不知女人是什么	news_story
山村50多年前制作的粮食加工机械，现在还能使用，城里人都没见过	news_travel
位置很差的水果店，如何通过一招将生意做成社区内最好？	news_finance
过人如本泽马？卡拉斯科点赞后引来马竞球迷指责	news_sports
九十年代乡村故事：她生完孩子后精神异常，常常说看见鬼了	news_story
就品质和质量而言，是小米好，还是OV好？	news_tech
中国股市的“庄家”到底是谁	news_finance
如果完全按以色列的思路，巴以问题将如何解决？	news_world
合伙开店如何转让股份？	news_finance
横扫东部第一？这事骑士已经干过一次！直接把对手打到解体重建！	news_sports
泰山酒店都不便宜，20年前都100多，现在的价格你肯定想不到	news_travel
在大连西山水库买房养老好不好？	news_house
错过了楼市，错过了比特币，下一个风口会是什么？	news_house
1.1秒牺牲自己，44毫米拯救4000人，烈士的母亲说：咱娃走得值！	news_military
深圳龙华民治一带到民乐一带，农民房价格大概多少？	news_house
趣谈文化：你意想不到的奇怪习俗，韩国用它来当作大礼	news_agriculture
此人一眼看穿孙悟空的筋斗云，连太上老君都忌惮三分，不是菩提	news_culture
次新股上市第一天如何买进？	stock
汽车销售小姐最怕消费者来这3招，这些销售内幕让人心寒！	news_car
《雍正王朝》四阿哥胤禛和十三阿哥胤祥，办差路过江夏镇为什么必须下马步行通过？	news_travel
在欧洲是夺欧冠难，还是夺联赛难？这篇文章将告诉您答案！	news_sports
千年德国小镇居民自称为“中国人”，中文是其官方语言之一	news_culture
国脚张呈栋：从没想过自己会出一本书	news_sports
5战115分，隔扣被犯规还“口出狂言”，球迷：听这话就有巨星潜质	news_sports
娱乐圈新晋小鲜肉大盘点，各个才艺双全，来看看有你的爱豆吗？	news_entertainment
怎么看微博大V爆料王者掉帧卡顿等问题是因为手机品牌保护费交的不够？	news_game
尼山圣地孔子湖畔千人徒步 快乐行走欣赏尼山美丽风光	news_travel
币圈事件：密货币是否成为证券，5月7号见分晓，后市操作见下文	news_finance
“零差评”的4部网剧，安悦溪上榜2部，最后一部总播放量破40亿！	news_entertainment
为什么高控盘庄家不能随意拉升股价？	stock
坐无底船过凌云渡时，孙悟空为何急着把唐僧推下河？	news_story
阿里巴巴最大股东是日本银软吗？	news_tech
谢娜创吉尼斯纪录，你知道是哪两项吗？	news_entertainment
轮胎需要定期调换吗？	news_car
中超单场消息：埃尔克森建功难救主 上港主场遭遇国安逆转	news_sports
WKG&M-1世界综合格斗赛明星见面会引爆鹏城	news_sports
刺激战场既然这么火，为什么要投放机器人？	news_tech
独家：狂野！狂野！与非洲狮近距离接触大汇总！	news_travel
如何看开盘，早盘，中盘和尾盘？	stock
有哪些日漫中有浪漫的樱花场景？	news_travel
东北多地要求多种大豆 要用中国产替代进口？	news_agriculture
王者荣耀排位征召，非你们不ban	news_game
《英雄联盟》选择大区后，游戏消失了，是怎么回事？	news_game
中国队亚洲杯抽到上上签，为何里皮脸色仍然很凝重？	news_sports
为什么说钓鱼穷三代？	news_sports
NBA和CBA差距在哪里？6张图一目了然！	news_sports
明星也爱吃棒棒糖，赵丽颖好甜，吴亦凡霸气，杨洋太魔性了	news_entertainment
有人说买房贷款越多越好、还款时间越久越好，真的是这样吗？	news_house
刚刚！达州宣布成功产出环保新材料：比头发丝还细！每吨卖2万！	news_agriculture
老婆每天晨跑回来满身是汗，无意翻看她的手机，我失眠了	news_story
这才是消费者想要的“共享”	news_tech
定位高端制造 打造千亿公司	stock
历史上的十大军事人才有谁？	news_military
2个人去西安旅游，从长春出发，大概要多少钱？	news_travel
你如何看待《甄嬛传》中教导甄嬛侍奉皇帝的芳若姑姑，她是个什么样的人？	news_entertainment
上市几个月市竟值跌去1400亿 众安等如此暴跌有缘由	stock
以色列警告称如果战机被击落将会轰炸俄军事基地，你怎么看？	news_military
目前有35万存款，怎样在短期之内翻倍？	news_finance
花5万买辆丰田普拉多，这车搭载V6发动机，所以觉得一点都不亏	news_car
北大校长口误念错发音 发表致歉信公开道歉	news_edu
武当掌门游玄德在生活中。比如街斗对阵泰拳王西提猜，结果会怎样？	news_sports
高考倒计时！渤海中学高三学生“立下军令状”为高考“冲刺”	news_edu
如果你喜欢《我的世界》，但是你妈妈又说《迷你世界》好，你会怎么办？	news_game
腾讯为什么会持有特斯拉5% 的被动股权？意味着什么？	stock
日本拼外交，诚意不可少	news_world
上联：青山润色三春梦，怎么对下联？	news_culture
与歼20竞标的“雪鸮”为什么竞标失败？	news_military
lol中，用武器打不死盖伦该怎么办？	news_game
百年五四堪回首──关于五四运动的前前后后	news_edu
如何看待阿里钉钉CEO的言论：不知道你们10点之前下班干嘛，不到1点不合格？	news_tech
全国十大重点产茶县之一“寿宁”	news_travel
明知木质甲板易燃防护性差，为何二战时日本航母偏要用木质甲板？	news_military
王者荣耀KPL：泥潭深入的QG和已经触底的AG，谁更值得同情？	news_game
株洲有哪些知名企业？	stock
别被大屏、天窗所迷惑，不管高配、低配，这些车载配置不能省	news_car
深夜无眠谁共语，如何对下联？	news_culture
和男友偷偷在校外同居，直到和妈通话时一辆卡车的喇叭声出卖了我	news_story
一个人去爬山合适吗？	news_travel
上联:落笔驚风雨，怎么对下联？	news_culture
奥运冠军领跑，省实南海5000家长学生共赴亲子跑	news_edu
如果爱：郑晴天是谁扮演的？倪景阳资料背景影视作品是什么？	news_entertainment
贾乃亮回归正剧 与毛卫宁合作《誓言》	news_entertainment
同等经济哪4个英雄最能抗伤害，白起难入榜，第一名没四个人打不死	news_game
如果将要取消物业，大家会支持吗，物业到底该不该存在？	news_house
小白如何提高苹果手机拍摄的技巧？	news_tech
南宁城市怎么样？适合东北人生活吗？	news_travel
九尾狐狸为何要附体在苏妲己身上？只因妲己的一项特质无以伦比	news_story
80后农民种菜致富1年纯赚70万 他发明1个销售绝招让他快速致富	news_agriculture
洛阳和西安比，哪个城市历史更悠久？	news_travel
表姐夫讲的真实故事：死亡征兆	news_story
如果证实反政府武装使用化学武器，美英法会被追责吗？	news_world
莱万与海因克斯决裂，拜仁还有必要留下他吗？	news_sports
上联：密密麻麻雨，轰轰隆隆雷，下联怎么对？	news_culture
未来，这几种菇农，将成为困难户！	news_agriculture
女乒今天排兵布阵不合理，丁宁昨天刚打硬仗，今天应该打第一单打，你认为呢？	news_military
孙坚送花，潘老师仿佛喜得贵子，来搞笑吗？	news_entertainment
小伙子收到花圈，遭女友闺蜜团诅咒：渣男去死！	news_story
中国和印度的经济差距怎么样，印度的邦跟中国县级市比怎么样？	news_world
孩子有这些情况，可能是脊柱侧弯！快看看你小孩中招没	news_edu
超级英雄演员颜值身材排名，钢铁侠进不了前5，第一名很意外	news_entertainment
合肥的房价2018年还会涨多少？	news_house
如果日本国土滑向海沟沉没，要求中国人民收留，作为中国人你会接受日本人吗？	news_world
北大校长致歉信近千字：只想让学生知道真实的自己	news_edu
「原创」酹樽：浅论军队实战化建设之“实”——解放军如何取胜？	news_military
浙江财经大学	news_edu
如果今年勇士夺冠，下赛季詹姆斯何去何从？	news_sports
美国参议员麦凯恩说他的葬礼上不请特朗普，大家怎么看？	news_world
图画说聊斋志异-画皮	news_story
美将用最先进导弹打击东风快递，性能超群，专家：难以探测	news_military
「跟着大V去旅行」来到开滦，走进这座活着的博物馆	news_travel
怎么看微博大V爆料《王者荣耀》掉帧卡顿等问题，是因为手机品牌保护费交的不够？	news_game
奔驰s350显示动力转向故障，挂不起挡位，是怎么回事？	news_car
歼20座舱盖上的两条“花纹”是什么？	news_military
为什么SUV没有轿车舒服，买的人还那么多？	news_car
鸭稻算什么，看看我们龙江的“天鹅稻”！	news_agriculture
停车时先踩离合还是先踩刹车？	news_car
浩大的都江堰万达文旅城分商业和住宅两部分，住宅转由融创开发了	news_house
为什么大众的车倒车时，后尾箱的把手（就是那个大众标）会翻起来？	news_car
上联：山水醉人何须酒。如何对下联？	news_culture
当前中国股市到底该不该抄底？	stock
上联：风伴红叶戏秋水，下联如何对？	news_culture
LOL：被安排？抛弃了女朋友和小明双排的Uzi首秀屡次却被黄金单杀	news_game
朋友圈里的各种信息怎么删除？	news_tech
坚守蓝筹白马 机构建议均衡化配置	stock
小时候，在农村读书的时候，你做过最后悔的事情是什么？	news_agriculture
如果以色列与伊朗发生战争，谁赢的可能性最大？	news_military
叙利亚政府军缴获霍姆斯北的反对派军火库，发现大批军火是俄制，这是怎么回事？	news_military
美军新型战略杀器即将问世，我军轰20还未研制完成！	news_military
詹姆斯再次绝杀，3-0领先猛龙，你怎么看？	news_sports
太幸福！詹姆斯绝杀之夜儿子前来观战！赛后父子俩一动作搞笑极了	news_sports
梦幻西游：让时光倒流，重回到2005年，看一下那时的梦幻攻略	news_travel
速写，要的就是速度	news_edu
惠州惠阳13000一平的房子值得买吗？	news_house
车跑70空挡N，50再挂D挡跑可以吗？	news_car
裸车价10万以内家用轿车有什么推荐？	news_car
去越南旅行，什么时候去比较合适？	news_travel
你对郑州尬舞团被取缔了怎么看？	news_house
二战，德国如果在击败法国后，不发动巴巴罗萨战役与苏联开战，改为修养生息。与英国僵持能否改变战争走向？	news_military
电视外接有源音箱有电流噪音怎么解决？	news_tech
最高法：上市公司对外担保合同不因违反对内程序规定而无效	stock
婺州家庭教育大讲坛暨环小暖爸活动在中国婺剧院举行	news_edu
上联，朱雀桥边照飞燕，如何对下联？	news_culture
交房租还是还网贷？“黑中介”捆绑网贷平台设“套”	news_house
雷军向李嘉诚展示重磅新机 问了这个问题	news_tech
郑州哪家卤肉最好吃？	news_house
以色列警告称如果战机被击落将会轰炸俄军事基地，你怎么看？	news_military
难怪老公跑长途从不喊累，原来有了这几款神器，简单实用	news_car
在和女生聊天的时候，如何快速找到话题？	news_culture
日本和以色列为什么会在贫瘠的土地上建立起高度发达的国家？	news_world
美国参议员麦凯恩说他的葬礼上不请特朗普，大家怎么看？	news_world
最牛国产豪车，比奥迪还漂亮，上市仅5分钟卖出8000+	news_car
一个人的善良，有时候真的可以改变另一个人的命运	news_story
老板让我找视频会议系统，有什么好的品牌软件推荐？	news_tech
《英雄联盟》RNG战队北京主场招聘赛事OB,要求段位电一大师以上，你怎么看？	news_game
纱窗坏了，别去维修 18年特流行这样装，防蚊防虫又保护隐私	news_car
开阳拉力赛赛道封路不要怕，赛道消息抢先知~	news_car
画家杨象乔以作品《蚩尤》讴歌民族精神	news_culture
这种长得像猫爪子的野菜，市场空间大，成了农民致富的“摇钱树”	news_agriculture
合肥有哪些计算机培训学习机构？	news_edu
特朗普是历任美国总统中最大的天才还是最大的蠢货？	news_world
国产沃尔沃，安全性能第一，故障率几乎为0，为何没人买？	news_car
《挪威的森林》讲述了一个什么故事？	news_story
一个公司从进入上市辅导到最后成功上市，一般还要经过哪些步骤？	stock
老婆在杭州工作，目前还无房，今年是否是在杭州买房的好时机？	news_house
房价会不会再次上涨？	news_house
在广西东兴可以开车去越南芒街吗？	news_world
上联：青山翠竹好时光，如何对下联？	news_culture
延续王者风范，全新一代奔驰G63正式亮相	news_car
未来张家口房价真的会暴跌吗？	news_house
在石家庄，和异性合租是一种怎样的体验	news_story
85岁老人剪碎14万现金，儿子3个月拼出10万8	news_story
汽车导航在保修期坏了，自己需要掏钱修吗，还是应该免费？	news_car
和普京同登《时代》周刊 杜特尔特：我可不是强人	news_world
还是卫生巾好用 立马就不流血了	news_story
兄弟两人哥哥去世了，父母的三套房产给哥哥的儿子一套，嫂子还能去争夺别的家产吗？	news_house
5月5日她味红糖亮相京东众筹首页	news_tech
湘西那边到底有没有蛊？	news_travel
为什么股东减持不走大宗交易而是在二级市场集合竞价交易？	stock
重新定义“智能汽车”，MARVEL X能成为荣威的“史册传奇”吗？	news_tech
微信支付是否已远远超过支付宝？	news_tech
假设一只股票开盘谁都不买，那是不是只要在涨停板挂一手买单，就能涨停？	news_finance
颖儿肉色礼裙出席活动，网友：透得太惊心动魄，不敢再看了！	news_entertainment
大连夫妇与中介公司口头确定买房后嫌中介费太高另投别家被打，你觉得中介辛苦介绍好房了之后变主意应该吗？	news_house
虽然中国女乒军团世乒赛3:1战胜日本，但日本球迷说不久日本女乒会赢中国，你怎么看？	news_sports
丰田在华想翻身就靠它了！比宝马5系还美，卖22万现在就存钱！	news_car
岳阳市温暖湿润，季节性强，热量丰富，严寒期短、无霜期长	news_travel
张靓颖透露右耳已经间歇性失聪10年，这些年她都是怎么过来的啊	news_entertainment
四野在东北的武器装备是哪里来的？	news_military
股票在什么时候最容易涨停？	stock
红寺堡区有房屋中介信息部吗？具体在哪？	news_house
联合国安理会改革废除一票否决权，会导致什么后果？	news_military
被很多农民嫌弃的野生植物，40元至50元一斤，快看看你家地里有吗	news_agriculture
中国车手何晓乐出征纽博格林24小时耐力赛，他喜欢什么样的耳机？	news_car
目前外资流入A股，真是因为A估值偏低吗？	stock
西安产融新时代 楼宇经济新方略	news_house
一懒一勤两兄弟	news_story
时光飞逝，无计留春住。怎么对下联？	news_culture
娱乐类小说，走进这个世界最大的名利场	news_entertainment
美国超级英雄是怎么来的？	news_world
马克思是世界上最伟大的哲学家吗？	news_culture
为什么很多股票屡创新低，而股指却高高在上？	stock
水泥钢筋价格大幅度的上涨，农村自建房怎么办？	news_agriculture
史上最牛的一部影视作品：很多人都没有看过生存之民工值得欣赏	news_entertainment
为什么录制《快乐大本营》的观众们没有爆料过？	news_entertainment
大连东港看起来那么现代，为何房子卖不动？	news_house
行车记录仪该淘汰了！如今义务造“8D魔术镜”大火，性能忒强劲	news_car
A股中的白马股闪崩跌停不断，下一个风口在哪里？	stock
王朔：全北京的青霉素都是从我手上发出去的	news_story
击败林志玲成为台湾第一美女，如今婚姻幸福让人羡慕！	news_entertainment
没有对比就没有伤害，我和你走的好像不是一个川藏线	news_travel
美军A-10攻击机，究竟是如何一战成名的？	news_military
石家庄夏季有休闲避暑的景区吗？	news_travel
手上有25万，房价7800，可以首付买多大的房？	news_house
宋鸿兵的《货币战争》这本书可信度有多高？	news_finance
SSG甜蜜购：区块链+电商 新零售2.0时代杨帆起航	news_tech
哪个国家可能会成为下一个超级大国？	news_world
古玩：地摊捡漏“八”大技巧	news_story
小Bu说：萌爆少女心，淡路岛11米“白色Hello Kitty”巨蛋开幕	news_travel
新能源汽车展在南京9月14日举办汽车行业盛宴	news_car
行云流水，句如晨风迎朝霞，如何接句？	news_entertainment
关于《红楼梦》中的那些经典词句，你读懂了多少？	news_culture
杨幂景甜徐冬冬唐嫣 不好好穿衣却美的有趣又撩人	news_entertainment
中国最难请的4位明星，第2无人不知，第4无人能请动！	news_entertainment
凯西教练：我们这个赛季已经命悬一线	news_sports
如何拿到香港金融牌照？	stock
机械扫描雷达与相控阵雷达主要差异是什么？	news_military
如何上传图片被百度收录？	news_tech
上联：江中鱼东游西藏，下联怎么对？	news_culture
太彪悍！解放军某炮兵连惊现上等兵“副连长”	news_military
大众得意B级车当年被疯抢，如今狂降9万没人买，家用还是很省心！	news_car
新能源汽车有发展前景吗？	news_car
怎样看股票里有没有庄？	stock
宋祖儿现身活动，着小公主的打扮也是好可爱呢，笑起来很有感染力	news_entertainment
「招人烦」的村第一书记	news_agriculture
「吃鸡竞技」系列文，大吉大利，今晚吃鸡！	news_entertainment
目前的股市行情你怎么看，是否会有新一轮的大行情出现？	stock
「EXO」「新闻」180506 剧情发展让人猝不及防 李代表那晚到底做了什么？	news_entertainment
Uzi直播首秀人气火爆弹幕刷到黑屏，黄金段位拿五杀称太简单！	news_game
牛股共同特征是什么？怎么轻松找到大牛股？	stock
打仗时，钢盔根本不能挡子弹，为何还一定要戴？	news_military
女儿为远嫁和我闹翻，两年没回家，我一路找去，推开门后老泪纵横	news_story
詹姆斯现在的绝杀球能力在联盟中是什么水准？	news_sports
企业管理软件系统哪个好？	news_tech
在互联网创业需要什么？	news_tech
河南话和广东话哪个更像是古汉语？	news_culture
23岁孕妈喜怀三胞胎，产检后却被赶回娘家，孩子出生后婆婆哭了	news_story
江苏开通首条国际邮轮航线	news_finance
被打服！骑士詹皇外一人让球迷心宽了，骑士凯尔特人宿敌再见？	news_sports
心疼蔡徐坤被激光伤害，嫌疑人声称就是要照死他，彰显人性！	news_entertainment
王者荣耀有哪些辅助可以出全输出装？	news_game
美国参议员麦凯恩说他的葬礼上不请特朗普，大家怎么看？	news_world
山东股最全一季报！逾六成业绩增长 这7只是社保基金“新宠”	stock
辽宁省突破秸秆生物炭规模化应用关键技术 生产成本仅为国外同类产品的15%	news_agriculture
没文化，没技术，如何找出路？	news_culture
九家公司股价不超过10元，花数亿元收购同行，股价能配合业绩吗？	stock
宝安石岩卖冰鲜海产去哪里进货比较合适？	news_travel
MSI入围赛Day4第一场：PGM 0-1 SUP，SUP再取一胜领跑B组	news_game
在中国的历史上，你认为谁最伟大？	news_culture
股票放量下跌是什么意思？放量下跌意味着什么？	stock
我一生的挚爱丰田皇冠汽车	news_car
哪些行为在产品开发中是耍流氓？	news_tech
印度这样放纵人口发展，最后明显是一大祸事，国家和政府为什么不加以控制？	news_world
今天有多少人发誓要销户远离股市？	stock
儿子结婚，不让父亲参加，突然来了十几辆豪车，才知父亲不一般	news_story
“CF”都出了英雄级，为什么还要出“王者系列”？	news_game
止损真的有必要吗，止损真的有用吗，只有1种情况才需要止损！	news_finance
5万元资金，该做什么行业？	news_finance
华峰股份：3月内不再筹划除购买华创股权之外重大事项	news_finance
孟津隐藏的这处美景，你来过吗？趁着周末约起来！	news_travel
美国法院判伊朗赔付9·11遇难者家属逾60亿美元，你怎么看？	news_world
传闻：《尼尔 机械军团》将登陆Xbox One平台	news_game
Angelababy出席活动，网友；模特出道的你，演戏一样不比别人差	news_entertainment
当年你的那些“死读书”的同学，现在都怎么样了？	news_edu
基金从业资格证书的含金量怎么样？	news_edu
三国杀里有哪些嘲讽度很高的武将？	news_game
朝鲜5日零时起 启用新平壤时间 与韩国统一时区	news_world
重磅：涨停板复盘！	news_finance
奇怪的现象，这个时代为什么只有粮食不值钱？	news_agriculture
杀人放火的鲁智深为什么会成佛	news_story
日本儿童人口连续37年减少	news_world
履行《板门店宣言》韩朝双方已完成扩音广播设备拆除工作	news_world
她曾被誉为“王昭君”，如今整得亲妈认不出，穿衣大胆不输范冰冰	news_entertainment
目前有35万存款，怎样在短期之内翻倍？	news_finance
蒙古国人口为什么那么少？	news_world
2018年俄罗斯世界杯12座球馆巡礼——伏尔加格勒体育场	news_sports
G7京新高速从天津出发到新疆沿途怎么玩好？	news_travel
湖北宜昌：最浪漫的相亲节在薰衣草花海中举行！	news_travel
A股市场哪几家公司是主营研发芯片的？	stock
那些十七八岁就结了婚的女孩子，后来怎么样了？	news_story
实拍：72岁老人再添一孩子，医生护士都为他竖拇指	news_story
能够连接印度洋和太平洋的泰国克拉运河项目是否已经开工，一旦建成对新加坡有影响吗？	news_world
降低郁闭果园密度！烟台大樱桃老果园改造关键技术	news_agriculture
上联是：柳映池塘鱼上树，如何对下联？	news_culture
太狠了！已有城市执行！有借呗、白条记录全都不能贷款	news_tech
科勒·卡戴珊与男友TT共进午餐，曾在他怀孕期间偷腥的渣男被原	news_sports
竞篮2串1：勇士客场擒鹈鹕 爵士主场再负火箭	news_sports
伊拉克战争时，萨达姆为什么会将其强大的空军战机全部埋葬，弃而不用？	news_military
在农村经常听人说“春栽杨柳夏栽桑，正月种松好时光”，这句话现在还适用吗？	news_agriculture
推进44毫米挽救4000人生命，山东小伙把28岁青春融入长空	news_military
日落霞飞苍山远，求下句？	news_travel
农村大集上54岁腼腆大哥靠竹丝大扫帚老手艺30年，年赚一万元	news_agriculture
“蒜你狠”变成“蒜你惨”，魔都蒜头最低5毛一个，不到最高时的一半	news_agriculture
王者荣耀哪些英雄大招技能最强呢？嬴政第二，第一神技能犹如外挂	news_game
25球！国家德比的头号射手——梅西	news_sports
贝克汉姆吴秀波金城武小李子，这几位帅哥大叔倾国之貌	news_entertainment
用微信做淘宝客怎么样才能精准吸粉？	news_tech
农村9旬老人生17个儿女全部夭折，老伴留的唯一财产是“纸钱”	news_story
上联：天高任鸟飞，下联如何对？	news_culture
上联：连天风雨送四月，如何对下联？	news_culture
父亲定时逼我喝中药，喝完眼睛疼，16年后我才知他残忍目的	news_story
大家怎样看“悦花越有”支付？	news_tech
一年前花了将近50万买了车库住人，现在不允许住人了该怎么办？	news_house
怎样购买药材种子	news_agriculture
高考要来了，高考回忆有哪些？	news_edu
宝马第一款三排SUV：舒适性和交互性之间达到了极好的平衡	news_car
管窥西泠印社前任副社长 大师方去疾篆刻艺术 01	news_culture
种植花生为什么要进行清棵，清棵的好处有哪些？	news_agriculture
次声武器属于第几代武器，它发展到什么程度了呢？	news_military
“福”字倒贴的由来	news_culture
看完哪些书会让你觉得作者的知识量真的很大？	news_culture
高房价真能控制人口素质吗？	news_house
全国这8个5A级别的旅游古城镇，你去过几个？	news_travel
叙政府军推进势头太猛，美舰载机猛烈轰炸报复，俄战机起飞对峙	news_military
安全倒车9不要	news_car
九年义务教育结束后，上职业技术学校好，还是技校好？	news_edu
潜伏如果陆桥山不死，会帮助余则成当上站长吗？	news_tech
芦笋种植年入百万！但这还不能满足他的野心……	news_agriculture
美患癌资深参议员术后出院 提前安排后事葬礼不欢迎特朗普	news_world
“专升本”录取工作5月下旬进行	news_edu
上联：梨开一树雪。下联是什么？	news_culture
装备通用问题破解！新型反舰导弹问世，所有军舰都能用	news_military
44岁女人得怪病像80岁老人，丈夫无法接受和她离婚！	news_story
聚焦未来｜专家热议汽车产业高质量发展	news_car
房企和炒房客“复盘无望”降价抛售将加快“房价下跌”	news_finance
中国当今有哪些超级工程？	news_military
二战最好的5大狙击步枪 盘点	news_military
客机成本那么高，为什么飞来飞去还能赚钱？今天总算知道了！	news_car
为什么《辐射4》被很多老玩家喷？	news_game
民间故事：选一块风水宝地，只因主人无德，结果一事无成	news_story
中科院发布一好消息，首款云端人工智能芯片问世，打破世界纪录	news_tech
以色列警告称如果战机被击落将会轰炸俄军事基地，你怎么看？	news_military
办理下来的工商银行信用卡刚额度有多少？	news_finance
乐福频繁一打三称霸猛龙内线 造就詹姆斯惊世绝杀	news_sports
农村俗语：“人穷断六亲”，这句话真实吗？为什么？	news_agriculture
日本和以色列为什么会在贫瘠的土地上建立起高度发达的国家？	news_world
假如一个人同时在3家保险公司买了意外险，出事了可以获得3份赔偿吗？	stock
四川游客张某带着六名女子在三亚沙滩烧烤被撒沙，这事你怎么看？	news_travel
来文山玩，可以带什么特产？	news_travel
你会和你的父亲相互递烟吗？	news_story
中国排在前600的姓都有哪些？	news_finance
农业农村部部长韩长赋莅临我校调研指导	news_agriculture
最强组合！华晨宇合作莫文蔚，全是《天籁之战》牵线	news_entertainment
新零售背景下，电商平台会发生什么变化？	news_tech
为什么很多股票低位长期横盘后砸盘出货？	stock
我和狗狗一起参加了登山比赛，我们完成了比赛，我们胜利了	news_travel
在日本免税店被坑，买的东西要怎么退货？	news_travel
为什么1÷3再×3的结果不等于1？	news_edu
被遗忘的10部国产良心剧，演员阵容强大，多个国家一级演员出演	news_entertainment
农村常见这种植物被称作生命之花，将它放在卧室有利于夫妻和睦！	news_agriculture
国内程序员那么多，为什么不开发一个属于自己的编程语言？	news_tech
奥兰多，安迪尔森，詹姆斯，穆谢奎，谁对大连足球的贡献更大？	news_sports
出生到现在从来没有谈过恋爱？不可置信的母胎单身偶像TOP7	news_entertainment
美国人问：非洲人如何看待中国在非洲的投资？某网民：我们很支持	news_world
如何看待日本的发展？	news_world
高龄产妇怀二胎带着大宝去产检，孩子说的这句话，让医生懵住了	news_story
广东今年将打造11条南粤古驿道重点线路，初夏郊游走起~	news_travel
雷佳音刘昊然这么多相似地方？刘昊然模仿雷佳音，昊然弟弟你变了	news_entertainment
征兵季！盘点军营5大“上古神器”, 看到第一个我就跪了	news_military
隆多疑似垫脚库里，勇士或向联盟讨说法，科尔：那是很危险的动作	news_sports
上联: 芦苇揺曳随风摆，下联如何对？	news_culture
证金公司逆市增持券商股 中小盘成长股逐渐被资金锚定	news_finance
五大“出轨“女明星，最后一个你们肯定不知道！	news_entertainment
国内各类大中型公司正版电脑软件使用率有多高？	news_tech
地表最强1.2T自主紧凑SUV即将上市，动力甩合资几条街	news_car
中石油2017年负债超万亿元 乐视网等15家公司已资不抵债	stock
在镇上开一家儿童乐园怎么样？	news_travel
1~6年级数学公式表，悄悄打印！给孩子挂墙上背，清华北大随便考	news_edu
中国2.0版航母战斗群浮出水面，“电飞鲨”放弃太行赶进度	news_military
牛头和马面的神话故事	news_story
溥仪剪辫子，所有人吓得跪地痛哭，现在，他的辫子每天上万人参观	news_story
买房付完首付后要到一个月才能拿到购房合同正常么？	news_house
住房公积金贷款如何申请到高额度？	news_house
丰田再次放大招，整车进口，格调不输奥迪A6，售价不足30万要火	news_car
你曾经崇拜过哪些现在看来很丑的偶像？	news_entertainment
经济学家吴敬琏为什么反对“不惜代价发展芯片产业”？	news_tech
天堂与地狱是有多近？看看比赛最后8秒的猛龙就知道了	news_sports
刘强东：对我做人影响最大的人	news_story
成年牛要想放牧育好肥，掌握方法是关键	news_agriculture
提个醒！8月1日起，没有这个证农资店将关门大吉	news_agriculture
如果美国退出联合国怎么办？	news_military
民间故事：黄大仙讨封，神仙说胡子超过尾巴，即可为人	news_story
新时代武侠小说的开山鼻祖到底是谁？	news_culture
美国法院判伊朗赔付9·11遇难者家属逾60亿美元，你怎么看？	news_world
李白、杜甫、陈子昂三人写白帝城的诗，看其心境与悲欢	news_culture
百岁老人独居深山40多年 自给自足做饭有“洁癖”	news_story
没买房和计划买房的注意啦！	news_house
你见过最努力的人现在都变成什么样子了？	news_edu
焊不锈钢，铝，铜，用那种焊枪最好？	news_travel
DOTA2 英雄之路启程 MDL金鹰电竞站战队巡礼	news_game
陈妍希，肉肉的小龙女，你喜欢吗	news_entertainment
海口绿地海长流开发商状告业主传播谣言 业主拿出质量报告反击	news_house
上联：握手一长叹；求下联	news_culture
想用十五万来创业，有哪些适合做的项目？	news_agriculture
你心目中的伟人是谁？	news_culture
中国移动5G联合创新中心天津开放实验室挂牌	news_tech
美国航母即使被导弹打的千疮百孔也不会沉没，它采用的是什么钢铁结构船体？	news_military
19岁的对越反击战烈士：如果有机会上战场，我一定冲在最前面	news_military
想买速腾的再等等！这车颜值逆天，溜背造型，比帕萨特便宜好几万	news_car
世界上哪个国家与美国友好？哪个国家讨厌美国？	news_world
顺产生娃，接生大夫是我暗恋三年的男神，我改天生行么？	news_story
每日房源推荐丨又是一年丁香花开	news_house
你希望利物浦赢得欧冠吗？巴萨主帅巴尔韦德的回答耐人寻味	news_sports
「评论」推进休闲农业与乡村旅游升级！致富多一条路！	news_travel
DNF：原来这游戏真的存在狗托，老马居然还对他疯狂暗示！	news_game
国内海军驱逐舰发展沿革	news_military
同事蹭我车上下班，他在车上说一话，从此拒绝他再上车！	news_story
上句：但愿人长久，下句怎么对？	news_culture
老婆真的好贴心哟！买这些车载用品安全又享受，驾驶万里都不怕	news_car
什么情况下我们需要毫不犹豫的卖出股票？	stock
老牛被商人出高价收购，大爷却不肯卖，知道原因后让人同情！	news_story
娄底城区2018年中职招生工作协调会在市第一职业中学召开	news_edu
《王者荣耀》新英雄米莱狄将在5月上线，她的出装攻略是怎样的？	news_game
除一些必备物品外，旅行时还有哪些省空间少重量又实用的东西？	news_travel
《王者荣耀》有哪些法师不依赖铭文？	news_game
大学毕业间隔年环游中国，做有意义的事情	news_travel
日媒：日乒和中国的差距正在缩小	news_sports
长安CS75这款车到底怎么样？看看车主400公里用车真实反馈吧！	news_car
你最喜欢的NBA巨星是谁，讨厌的巨星又是谁，为什么？	news_sports
Rich Brian expected at the Westlake Music Festival!	news_edu
非洲为什么没有熊？	news_world
俄罗斯军人很爱喝酒吗？	news_world
法网卫冕冠军在马德里首轮出局，法网卫冕前景蒙上阴影	news_sports
F22比J20体积小却重得多，请问F22航程是不是很短？	news_military
美国声称“没有输过任何一场战役”，但是为何美国却输掉了越南战争？	news_military
从《中庸》到《声律启蒙》，不一样的小朋友，一样的萌｜赵师汉学	news_culture
你的转发会帮助很多人！	news_car
巴菲特：不太可能向其股东发放一次性特别股息	news_finance
营口：“五一”期间 鲅鱼圈区接待游客近30万人次	news_travel
詹姆斯又双叒叕绝杀，洛瑞直接懵逼	news_sports
只有6万现金，想买个合资车型，有没有可以推荐的？	news_car
45岁男子一日三餐都是吃石头砖头，啃石头就像是吃着美味的鸡腿	news_world
勒布朗詹姆斯和骑士如何改变季后赛命运？	news_sports
天赋超越泰森，波兰猛将只因一大天生缺陷无缘世界拳王	news_sports
房价走势如何？	news_house
柬埔寨东北部发生中毒事件 已致6人死亡52人住院	news_world
毛晓彤出席活动，网友：一条朴素的连衣裙和她甜美的笑容真耐看！	news_entertainment
宁波的天宫庄园适合去秋游吗？	news_travel
如果能带五本书穿越到古代，你会带哪五本？为什么？	news_culture
这支球队老板出场踢三场足协杯创历史，球队三轮狂丢14球也创纪录	news_sports
全球7对另类“神奇情侣”大比拼，让人啧啧称奇！	news_world
这一球之后，来看看各路球星怎么就变“詹吹”了	news_sports
任志强发声：3月以后楼市肯定发生变化，你怎么看？	news_house
社保不想续交了，已经交的钱能不能退？	news_finance
2018年5月6日生猪价格行情 供应相对充足猪价逐渐趋于稳定！	news_agriculture
上联：江中鱼东游西藏，下联怎么对？	news_culture
哈尔滨一弃婴被荷兰父母领养，16年后凭一张纸条回来寻亲，你怎么看？	news_world
瑞典世乒赛中国女队夺冠，如何看待新闻发布会上石川佳纯充当中国翻译？	news_sports
流浪狗扰乱正常教学秩序，破坏学生们生活，该怎么办？	news_edu
“现在抓紧买房，十年以后买不起”，对于这种说法你怎么看？	news_house
为了寻找小时候的记忆，一大早往老家赶，找的就是这种酱果树莓	news_agriculture
你认为班主任，老师，学生三者之间的关系是什么？	news_edu
股票在高位的时候成交量没有放大，到了低位的时候成交量放的很大，这是主力在建仓吗？	stock
大叔野外捡到三只鸡蛋，本以为是意外收获，结果差点有牢狱之灾	news_agriculture
珠海这个绝美的海景驿站升级改造完成！空气清新，骑行晨跑便利！	news_travel
下班后，有什么可以在网上做的兼职？	news_tech
拉美裔女明星吉娜·罗德里格兹，街头拍电影亲吻	news_entertainment
农村出身的朱之文为什么回到农村不受大家欢迎？	news_agriculture
马化腾为什么不把南非的股份收回来？	news_tech
没有经验可以做什么店？	news_game
西蒙斯：我们凉凉了，0-3没希望了，球迷：你们需要詹姆斯，追吧	news_sports
儿子的同学借给他几本书，说是作文想得“奖”，熟记下来准没错	news_edu
52岁的刘嘉玲，62岁的刘晓庆，整容绝对不是最好的抗老秘诀	news_entertainment
农村小伙教你几招：轻松挑选出优质的东北大米	news_agriculture
美国建国不过两百年，为什么会成为世界强国？	news_world
怎么样看待大连一方在中超联赛第九轮取得的赛季首胜？	news_sports
煤价上行有望反转 不惧短期季节波动	stock
LPL冠军UZI虎牙直播首秀 弹幕人气排行双双第一！400万爆炸人气！	news_game
本金120万，融资60万，总资金180万，专职炒股怎么样？	news_finance
现在手里面有两万块钱的闲钱，不是很多。这笔钱怎么在一年时间内赚最多的钱？	news_finance
做好短线的关键在于哪里？	stock
LOL中哪个英雄最克劫？	news_game
让孩子赢在起跑线上	news_edu
《说文解字》有什么证据说字的本义，不是臆想呢？	news_culture
有什么唯美剧情的手机单机游戏？	news_game
法治聚焦｜多部门联合发文规范民间借贷，严厉打击暴力催收	news_finance
特朗普为挺拥枪嘲讽巴黎恐袭，法国怒怼“可耻”	news_world
为什么泰国没有假药？	news_world
深圳证监局“挥刀”私募新三板 重拳出击违法违规	news_finance
马克思是世界上最伟大的哲学家吗？	news_culture
不管是奔驰，宝马，还是国产汽车，装上这些黑科技神器，高级有面	news_car
高考，能上重点大学，可是因触犯底线，他竟然跪下了	news_edu
重大利好：通策医疗突发重磅信号，下周抄底最佳时机出现！	news_finance
建安七子之首王璨是在什么样的情况下创作了《登楼赋》？	news_culture
这两种极端背单词方法你会选哪种？后一种效果没你想的那么好	news_edu
高通骁龙845和835相比，性能有哪些提升？	news_tech
贵港故事：刘三妹的传说	news_story
道义放两旁利字摆中间，屡战屡败的曼萨诺还能走多远？	news_sports
李永培：课程方案调整、高中教材变革将倒逼高考改革进一步深化	news_edu
如果迷你世界和Mc相互PK，你觉的谁会赢？	news_game
还大热天在瓜棚照看瓜吗？有了这“黑科技”，随时随地查看地里瓜	news_agriculture
预算十万元买什么SUV好？	news_car
骑士VS猛龙G3，乐福在内线强硬一打三，你怎么看？	news_sports
大众最得意B级车又降了！当年卖25万被疯抢，如今狂降9万没人买	news_car
加拿大男子卡在女厕墙中身亡	news_world
刘诗诗：出席活动，网友：天鹅颈只服刘诗诗，美呆了！	news_entertainment
在战场上击倒敌人需要补枪吗？	news_military
2018中考英语最后冲刺书面表达之日记 记叙文or议论文	news_edu
同学聚会，同学介绍我“他是我司机”，我尴尬，他再说的，我感动	news_story
寒武纪发布新一代AI芯片采用7纳米 华为麒麟980将整入寒武纪IP	news_tech
玉米“多穗”现象形成的原因有哪些？该怎么预防？	news_agriculture
去长白山玩，有什么特产值得买？	news_travel
同样是国家陷入内战，为何卡扎菲最终丧命而阿萨德一直稳坐江山？	news_military
福建农村电网改造助力乡村振兴	news_agriculture
安永：全球并购交易势头正旺不受风险影响 中国为首选五大投资目的地之一	news_finance
小米作为手机行业的佼佼者，他在汽车行业何去何从	news_car
查理芒格谈人工智能：炒作过多 还不能大规模取代人类	news_tech
腾讯的老板马化腾凭什么获得“全球最伟大领袖”的称号？	news_tech
MSI投票榜：Uzi人气爆棚 小花生为非LPL选手第一	news_game
骑士6天里发生了啥？从首轮抢七到次轮3-0猛龙	news_sports
《魔兽争霸3》的职业选手，能打赢两个业余选手吗？	news_game
在历史上或者你身边，有哪些“丁”姓的名字让你念念不忘？	news_culture
离被横扫不远？猛龙系列赛6困扰难解决：1优势骑士轻松破除	news_sports
杨洋就是我们的皮系网管“皮皮修”没有错了！	news_entertainment
以色列警告称如果战机被击落将会轰炸俄军事基地，你怎么看？	news_military
稳定的实力，灵活的规划，在新兴虚拟货币中独迈阿币别具一格	news_tech
为什么一夜之间冒出那么多全款买房的有钱人？	news_house
凯西谈德罗赞：投不好也可以做其它事，比如防守	news_sports
日本楼市泡沫到后期是怎样一副光景？	news_house
小翠-聊斋志异	news_story
普京在刚上台时说要带领俄罗斯成为强国，就目前的形势来看，俄罗斯是否成为了强国？	news_world
菲律宾学英语「宿务」C2 Ubec English Academy	news_edu
海口塔昌村：打造原生态农宿 探索农业观光新业态	news_travel
如何利用手中股票做T+0？	stock
手中资金大约600万闲置资金，房产已限购，该怎么配置投资？	news_house
作为玩家/赛事观众，你能够接受LOL的版本平衡吗？	news_game
中国的辽宁航母战斗群的战力如何？	news_military
夏天汽车热得像“蒸笼”，太难受！聪明老司机这样做，30秒降温	news_car
“东方莱茵河”竟然藏在京郊这座又大又美的公园内！关键免费玩！	news_travel
英国、俄罗斯、乌克兰、加拿大、澳大利亚、德国和西班牙，哪个国家的治安最好？	news_world
有色行业一季度业绩增逾六成	stock
为什么会出现“房价跌了反而卖不出去”的现象？	news_house
三大股指暴跌，后市该如何走？	stock
我结婚，同事随礼800；他结婚，我随礼300；他在微信上说了15个字	news_story
2018季中冠军赛第四日赛事前瞻：B组入围赛谁能觐见FW？	news_game
曝光台：违反禁令标志	news_car
米体：比格利亚将在意大利杯决赛中复出	news_sports
大蒜产地蒜薹大面积滞销，农民辛劳一天，蒜薹还是要扔丢	news_agriculture
5月的热点会是医药股吗？	stock
被判98年的男子只坐了8年牢，警察再抓他时20万人为其求情	news_story
爵爷，请你为自己再赢一次！	news_sports
世乒赛决赛刘诗雯痛失2赛点，遭伊藤美诚逆转。究竟是哪里出问题了？	news_sports
俄罗斯展示新型无人机，自称强于美军！不如买中国的吧	news_military
2018.5.6今日最新猪价	news_agriculture
凌晨出门干活遇到“鬼推车”	news_story
办信用卡多久可以换工作单位？	news_finance
豆腐渣混玉米杆粉发酵变酸能喂猪吗？	news_agriculture
如何看待弯道超车的行为？	news_car
直击：火葬场工作的女化妆师，已看不出年龄性别，生死早已看淡	news_story
我全款买的房子，凭什么要拿来给你弟弟当婚房？	news_story
lol国内联赛、msi、洲际赛和s赛，这四项赛事哪个含金量最高？哪个最低？	news_game
NBA最新票价排名！勇士队第一，火箭队看了都尴尬	news_sports
2018年全国GDP增速排名说明了什么？您怎么看？	news_finance
新闻简报：8.7亿！阿里首次公布支付宝们全球活跃用户数量	news_finance
《刺激战场》换弹速度最慢的武器有哪些，性能如何？	news_military
美国成了日本车的天下，为什么美系车在本土迅速堕落？	news_car
这篇关于马云的文章，受益匪浅，我都看了很多遍了	news_finance
骑士和步行者战成抢七险胜，而猛龙即将被横扫，步行者跟猛龙的区别在哪里？	news_sports
哈登和保罗激烈争吵，保罗伸手还被哈登打飞，安德森全程看呆，最后相互不理，怎么看？	news_sports
秋名山车神都虚的！重庆这些公路只有老司机才能驾驭，风景美如画	news_travel
江西职业农民带薪种田	news_agriculture
七个工作日3家外资机构申请控股券商	stock
有哪些我们很少关注的国家，却有着全球前列的科技产品？	news_tech
中国辽宁航母战斗群的战斗力如何？	news_military
英语六级很难吗？	news_edu
美国建国不过两百年，为什么会成为世界强国？	news_world
民间的传说，“酸儿辣女”是真的吗？	news_culture
特警进重庆川外当老师，手把手教“女子防身术”	news_edu
50岁了，一直是电商方面自由职业者，现在准备职业炒股从哪里入手？	news_finance
刚刚！马云正式宣布开放余额宝！4.7亿人喜极而泣！	news_finance
如果腾讯、阿里开始做农资了，你觉得会怎么做？	news_tech
探讨：乡村旅游的N+1种新玩法，值得借鉴！	news_travel
俄罗斯警察的腐败程度有多高，说出来可能都没人相信	news_world
5月，河南限行城市及限行区域又有新变化，车主们速看！	news_car
越看越亲切的越南，不得不说的中西文化交融之地	news_travel
胎儿真的有记忆吗？看完这些孩子们的回忆你就知道了	news_story
十八线女星嫁百亿富豪，打败徐若瑄陈怡蓉成功嫁入豪门	news_story
军事介入叙利亚超2年，军费超50亿，为什么普京却笑开了花？	news_military
为什么很多股票大盘涨而不涨，大盘跌而跟着跌甚至屡创最低价？	stock
懒人适合种的果树：长得多、好打理，你吃过几种？	news_agriculture
想带二老去湖北游玩，非自驾，预计花费5000，有没有攻略路线推荐？	news_travel
九年首次！伯克希尔一季度亏损，巴菲特却靠苹果派息大赚一笔！	news_finance
秦岚拍婚纱，无比美！网友：今天，你要嫁给我？	news_entertainment
大户一直在抛售，股价却没有下跌，是什么原因？	stock
华州：军地联谊搭鹊桥，兵哥靓妹喜牵手	news_military
斗鱼黄金大奖赛第四季选拔赛开始，水友点赞热度再创新高	news_game
上联：苦雨虐荷，岸边老柳长垂泪；如何对下联？	news_culture
要饭的与做官的（幽默故事）	news_story
新手买房，是找中介好还是自己去售楼部买更好？有什么需要注意的？	news_house
好莱坞今日最佳着装	news_entertainment
为什么有些斗鱼的主播们这么喜欢拿观众当傻子一样耍？	news_game
高考“白卷”考生10年后考取大专 后悔浪费高考机会	news_edu
李淑贤死后，为何坚决不与溥仪合葬？原因听完让人寒心	news_story
斯诺克世锦赛半决赛，马克-威廉姆斯17-15霍金斯，希金斯和威廉姆斯谁能夺冠？	news_sports
如果所有银行不让支付宝绑定银行卡了，支付宝会怎样？	news_tech
人这一辈子会去哪些地方旅行？	news_travel
双刃剑！山东鲁能高中锋让人又爱又恨	news_sports
长5米，比迈腾大一圈，无奈被奥迪A6狂虐，直降7万销量惨淡	news_car
波兰国防部长为何称美国驻军是波兰梦想了几十年才完成的事情？	news_military
青岛乡医人均收入增加近万元 村卫生室药物补助提高	news_agriculture
高考只剩一个月，应该怎样复习？	news_edu
脍炙人口的醉翁亭原来是这个样子，这里的山水的确很美	news_culture
新星宇万城地产双盘联动产品发布会今日举行	news_house
房价涨那么高，为什么还有人抢着买？	news_house
3款被公认贬值最快的合资车，二手车贩都不愿意收	news_car
资管新规出台，对股市短期有大的影响吗？	stock
去北海道，有什么推荐新奇的温泉胜地吗？	news_travel
在加拿大生活，消费如何？	news_finance
为何江西能成为国内民众五一假期游的首选之地	news_travel
日本人如何夺走中国烹饪的世界地位？	news_world
像委内瑞拉这样的国家和人民，是怎么混成连饭都吃不起的，根本原因是什么，如何挽救？	news_world
道士在院里吐了一颗桃核，数年后一颗桃子救了孙子	news_story
华为手机音量小，一定要按这个按钮！赶快试试吧	news_tech
马克思的宣传画 浓浓的历史感	news_culture
官总一个职业选手被路人大神说是总导演？这得花多少钱？	news_game
阿里旗下支付宝有梦想有情怀，码商成长计划承诺助力小微企业成长	news_tech
假期里，别样的旅行！	news_travel
魔兽世界杂谈：可怜的玛法里奥！你究竟还要凉多少版本？	news_game
黑龙江抚远开展最大规模大马哈鱼放流行动	news_agriculture
没文化、没技术，如何找出路？	news_culture
敢于质疑是高等教育的价值所在——引自新书《不要假装读大学》	news_edu
杭州出发2h去这个初夏度假地，乐享田园星空轰趴、负氧离子爆表	news_travel
如果所有银行不让支付宝绑定银行卡了，支付宝会怎样？	news_tech
东北雪乡景色美，网友称：真是一场斗智斗勇的旅行	news_travel
奔腾T77这款概念车怎么样？	news_car
18年大蒜的市场行情怎么样，价格有没有可能提高？	news_finance
马云又出惊人言论，8年后房子最不值钱，他的话可信吗？	news_house
股神巴菲特也看多A股？	news_finance
五月份是买房的好时间吗？	news_house
钱程：如何认识K线反转形态并成功抓顶抄底	news_finance
德国为什么会在第一次世界大战中战败？	news_military
英雄联盟最适合开团四大上单，猴子上榜，第一见人就上	news_game
俸周耀：房地产品牌21条商规	news_house
为何奥巴马刚上台就获诺贝尔和平奖？他给世界带来和平了吗？	news_world
重庆刚需5月买房，能买洋房何必高层？	news_house
测试发文1525589004.3	news_entertainment
离婚以后的女人很麻烦，找个女朋友也很麻烦	news_story
NSAC的证书是认可的吗？为什么在国家证书查询中查询不到？	news_edu
二战德军进攻苏联有没有比巴巴罗萨计划更好的作战方案？	news_military
微视频｜一分钟领略绵竹年画村”画景”	news_travel
有哪些科学解释不了的事实或现象？	news_world
只因朋友称《绝地求生》更好，“堡垒”男子将其刺伤	news_world
山东鲁能有没有可能拿到今年的中超冠军？	news_sports
多个好盘入市！2406套优质房源今起登记！	news_house
发布落户宽松与人才引进政策，天津、青岛加入“抢人”大战。你觉得这些城市对年轻人有吸引力吗？	news_house
月工资多少才可以养得起10万左右的车子？看完后涨知识了	news_car
资本市场法律尊严不容戏弄	stock
DNF：强化上12连续失败怎么办？这位大佬的做法太霸气！	news_game
今日消息面：BCH上涨近3倍，高晓松称数字货币可理解为地下黄金	news_finance
曼联传奇主帅弗格森突发脑溢血入院，现在情况如何？	news_sports
什么时候开始都不晚！宗庆后亮相《朗读者》第二季，他是这样读给年轻新一代的	news_entertainment
故事：张公解梦	news_story
西安房价还会涨吗？几方面分析西安房市水平！	news_house
这类股你敢买吗？	news_finance
话题作文怎么写？送给你12个话题素材，用好了作文都会出彩！	news_edu
巴西赛区KBM战队：感谢粉丝和所有的一切	news_game
庄家是如何给散户下套的？	stock
美股没有涨跌限制，T+0交易为什么没有暴涨暴跌？	stock
安倍最想销毁的瞬间照，十分尴尬，颜面尽失	news_world
链家左晖：我们和同行早已不在一个时代	news_house
上联:十面埋伏刀斧手，下联？	news_culture
足球茶馆：作为国米球迷你都知道吗？	news_sports
为什么江苏的考生总说他们有多牛逼？	news_edu
蔡徐坤到底做了什么事，见面会表演要被全程激光笔照，险些失明！	news_entertainment
拿到驾驶证后，不敢开车上路的是什么人？	news_car
尚未成年的夏洛特小公主竟然主动亲吻别的男人	news_world
林徽因什么理由拒绝了徐志摩而选择梁思成为终身伴侣？	news_culture
可以娶巴基斯坦的女士吗？	news_world
普通外汇投资者该如何炒外汇？	news_finance
我没钱只买得起盗版书，这可耻吗？	news_culture
马上21岁了，一事无成，想学个技术。学什么好？	news_edu
股票质押是利好吗？	stock
老太心地善良 救了受伤的猴子 却意外的养活了孙子 还救了他一命	news_story
大吉大利，晚上吃鸡，来看你是那种吃鸡选手！	news_game
《炉石传说》现在不花钱还能有较好的游戏体验吗？	news_game
农村很多算卦的据说很准，你怎么看？	news_travel
这样的老师最受学生欢迎！	news_edu
刺激战场：连接两个最偏僻点的航线，知道它的并不多	news_travel
山西：木乃伊、狮身人、沙比提 古埃及文明神秘之旅等你来！	news_culture
人工智能有多火？全国首个人工智能课程已经中小学落地了！	news_edu
上联：沉鱼落雁千君醉，如何对下联？	news_culture
白杨导弹能否打死恐龙？	news_military
手机上有什么好玩的大型游戏？	news_game
楼盘售罄后，销售员去哪儿了？	news_house
三大指数震荡整理题材概念股闻风而动	stock
西安房价会涨过2万的均价么，如果跌的话还能跌回原来的6千么？	news_house
为什么《英雄联盟》国服皮肤卖那么贵？	news_finance
有哪些明星明明长相很普通，却总演高富帅？	news_entertainment
如果保险公司破产了，买的保险该由谁来负责？	stock
每个大学后面都有一个大佬，你们猜是谁？	news_edu
老婆生完孩子后胖如猪，嫌丢人提离婚，一年后超市相遇我成笑话！	news_story
联通10010人工服务老是打不通是什么原因？	news_tech
恒大、富力、碧桂园、中梁等地产公司相继进入临汾，你会买哪的房	news_house
LOL不离开高地也能获胜？疯狂玩法大战60分钟	news_game
小龙女失踪半年，曾为见成龙自残，成龙欲秘密见小龙女	news_entertainment
酷炫！成都一高校情侣毕业返校拍另类婚纱照	news_edu
《西游记》中的各路神仙，腾云驾雾动辄十万八千里，为什么没有发现地球是圆的呢？	news_culture
美国建国不过两百年，为什么会成为世界强国？	news_world
马云：阿里不愿招北大清华毕业生，他们应该到中小企业	news_tech
众泰T3001.5手动豪华落地多少钱？	news_car
民间故事：黄鼠狼嘴馋，偷了蛊婆的鸡，反中河豚蛊！	news_story
宋清辉：资管新规出炉意味着打破刚性兑付	news_finance
维亚利：尤文不应该签埃姆雷-詹，而该选拉基蒂奇	news_sports
美出台国防授权法案应对中俄竞争，国防预算超7000亿美元	news_military
一些农民收割油菜后，为什么要把它放在家里堆上几天才去翻晒求籽？	news_agriculture
中国人气女明星排行榜2017前十名，谁知道是哪几位？	news_entertainment
如何评价演员刘芊含的演技？	news_entertainment
2018至2020年房子是涨还是跌？	news_house
西北工业大学情系城固山区教育	news_edu
大学生毕业在即，准备二战考研，但是学校逼着签三方协议，这样合适吗？	news_edu
小姑子结婚，老公不让我去，知道原因后，我给婚礼上送了个花圈	news_story
妩媚女兵不让须眉：以色列女兵演训生活图照	news_military
以茅台酒现在的价格，你认为它还是用来喝的吗？	news_finance
想从事UI设计，该怎样入手呢？	news_tech
在深圳，作为有钱人是一种什么样的体验？	news_house
京剧油画图集/	news_culture
三百温商共同发起，为温州企业家量身打造 “慧商大学”正式挂牌	news_finance
以色列警告称如果战机被击落将会轰炸俄军事基地，你怎么看？	news_military
为什么说种姓制度制约了印度的发展？连阿米尔汗都承认这点	news_world
说桂林山水甲天下的人都是因为没有到过贵州，不信你看	news_travel
马克思是世界上最伟大的哲学家吗？	news_culture
“钓鱼穷三年，玩鸟毁一生，一朝学会狗撵兔，从此踏上不归路”，各位怎么看？	news_story
为什么少林寺没有参加两次华山论剑？	news_culture
洛阳当地人最认可的烩面店是哪些？	news_travel
CAD基础级练习题使用构造线命令及详细答案（13）	news_edu
幽默笑话，早上起不来床，晚上下不了线	news_entertainment
孟婆汤真的可以遗忘前世的记忆吗？为什么人都记不起三岁前的事？	news_story
分红险、万能险、投连险有什么区别？	news_finance
为什么英国组建“反俄联盟”？	news_world
产业上下游面对面 服装定制商走访柯桥本土面料企业	news_finance
谢丽尔·科尔：被认为是最美丽的英国女性，英国民众心目中的女神	news_world
大连海那么多，都有什么海上游乐项目？	news_sports
世乒赛1/4决赛马龙和许昕均取胜，为樊振东铺平道路，你如何看待？	news_sports
绝地求生5月份新版本都有哪些改动？	news_game
「技术看盘」天策：低位次新股的买点在这里！	stock
上联。山西山东太行山。下联？	news_culture
房屋被征收方强拆，已过起诉时效，还有什么救济方法？	news_house
GPP排他性协议引发巨大争议，Nvidia该怎么收场？	news_tech
上联：风吹干了相思忆，如何对下联？	news_culture
十万元能上路的汽车，买什么比较好？	news_car
白送一个点球！恒大都不要？卡纳瓦罗笑容真有意思	news_sports
骑车旅行到达大连晚上在海边别墅扎营	news_travel
大麻竟被做成了衣服	news_finance
签署《离岗通知单》约定商业秘密保密义务是否有效？	news_house
养殖户希望猪价再跌一跌，农村散养户和规模化猪场谁能笑到最后！	news_agriculture
开盘：两市高开沪指涨0.31% 石油行业强势领涨	stock
如何高效防治葡萄的白粉病？	news_agriculture
广交会到会采购商与成交额实现双增长	news_finance
人和逼平鲁能，京城狂涨粉，北京国安下轮有望登顶！	news_sports
宁阳县堽城镇有个张阁老山，据说与八仙之一的张果老有关	news_story
如果你已然衣食无忧，有200万闲钱做投资，你会如何使用？	news_finance
国内哪一家航空公司的飞机餐最好吃？	news_travel
如何读懂一个上市公司发布的年报和财务报表，有哪些重要指标？	news_culture
让40国军人对它都爱不释手，中国的这套军服到底有多大魅力	news_military
一元硬币是这种，现在价值24000元，找找看！	news_culture
去年股市极为不平常，涨指数跌个股，2018年股市会走向何方？	stock
你玩过剧情最好的RPG游戏是什么？	news_game
“不差钱”的上市公司却偏爱理财 这说明了什么问题？	news_finance
“现在抓紧买房，十年以后买不起”，对于这种说法你怎么看？	news_house
每天一款复古车｜70年老哈雷改装欣赏	news_car
五角大楼怒了！昨日两架美机硬闯我军基地，俩飞行员受伤紧急送医	news_military
巨化股份，未来行情怎么看？	stock
山东日照2018年买了房子之后，房价跌了怎么办？	news_house
美国参议员麦凯恩说他的葬礼上不请特朗普，大家怎么看？	news_world
为什么许多中国人喜好去泰国，而不去三亚？	news_travel
买房应该重点看什么	news_house
把孩子送去夏令营合适吗？	news_edu
从一线城市回太原工作是怎样一种体验？ ​？	news_house
信用卡账单免息期与最长50天免息还款技巧大全！	news_finance
嘉兴秀洲中安银领国际，房价低的没底线，能买吗？	news_house
古代日本派大批女子前往中国，专偷一样东西，之后日本人更加自信	news_world
DNF：在游戏中最让人无奈的事情有哪些？	news_game
你怎么看待父亲精神分裂，母亲下肢残疾的他高考却被清华录取？	news_edu
洋眼看江苏活动走进大丰	news_travel
《雍正王朝》里赵毅版的李卫演的好还是《李卫当官》里徐铮版的更出色？	news_entertainment
资管新规后有多少资金要重新找出路？会流向哪里？	stock
有些爱，我想邮给您！“十年·邮爱”主题活动正式启动	news_travel
普通外汇投资者该如何炒外汇？	news_finance
宿城举办现代服务业招商推介会 28个项目成功签约	news_finance
李书福这次火了！国产“路虎揽胜”来袭，不足20万，买途观后悔	news_car
《我的世界》：它是最可怜的生物，想要靠近玩家，却又让玩家害怕	news_game
原来贾蔷是这么搞定贾珍贾蓉父子的	news_culture
母亲和老同学们聚餐，带去了六岁的宝宝，之后大家都删了她好友！	news_story
泰国男明星里的同志“天菜”，快来看泰国小哥哥了！	news_entertainment
雪铁龙在华销量低迷却喊出“因你不同”	news_car
梦幻西游：这藏宝阁100万摆不开的召唤兽，10分钟之内必然被秒？	news_game
日本新干线与中国高铁有啥不同	news_house
张靓颖间歇性失聪	news_entertainment
特朗普为支持拥枪 拿伦敦当“反面教材”	news_world
为什么罗斯福新政时宁愿把过剩的牛奶、棉花扔掉也不免费分发给穷人？	news_world
美媒报道中国40个最美丽最值得游览的景点，这里有你喜欢的吗？	news_travel
张杰写给谢娜的信，女人看了都会感动	news_entertainment
为什么股东人数大幅减少，筹码更为集中而股票却一直下跌？	stock
美国建国不过两百年，为什么会成为世界强国？	news_world
“轻风细柳，淡月梅花”，在这两句诗中各加一个字作腰，加哪两个字最好？	news_culture
这个13岁女孩从荷兰来到萍乡，只为全城寻找她的亲生父母！	news_world
G3，76人最后时刻疯狂庆祝，为什么反而输球了？	news_sports
在华销量破10万，限量版跑车售罄，CX-8成热点，马自达信心大增	news_car
可转债卖出该如何操作？	stock
全球最危险6大犯罪集团，排第一位的战斗力凶悍，跟特种部队硬干	news_world
五十退休早吗？	news_world
今日午盘：石油板块走高 沪指翻红微涨0.06%	stock
世界残疾人射击锦标赛，河北姑娘破世界纪录夺冠	news_sports
为什么很多人炒股同时用很多台电脑？	stock
如果你没钱，没能力，没人脉，就应该这样干！	news_story
这个亚洲最土豪的国家，民众生活政府掏钱，但却为娶媳妇而发愁	news_world
赵姨娘作为良妾，为什么在贾府的地位还没袭人高？	news_culture
建信基金梁洪昀：2018投资三大关键词	stock
这次中美经贸磋商，美国终于认清这样一个现实	news_world
五月份是买房的好时间吗？	news_house
民国军统绝美特工，为上司生了8孩子，被当精神病关进疯人院	news_story
夏威夷四岛攻略｜这样玩才叫去过Aloha！	news_travel
王者荣耀的哪个英雄或者哪个技能最让你怀念呢？	news_game
为什么有些开好车的女生很漂亮？	news_car
庄浪，你是人间五月的天堂	news_travel
以色列为什么最近要和伊朗针锋相对？	news_world
为什么中石油和中石化会亏本？	stock
AMD出的2200G或2400G玩“吃鸡”的效果如何？需要增加独显吗？	news_game
有人认为当美国总统很辛苦，那为什么一些人还争着当？	news_world
如何判断一个人是聪明还是笨？	news_finance
AK47为什么能成为枪中之王？	news_military
亿航在西安的无人飞机秀演砸了，但并不影响继续它的表演	news_travel
叙利亚总统阿萨德会成为第二个卡扎菲吗？	news_military
龙虎榜：老妖王万兴科技再启动二波试探 A神+落升共板	stock
如何正确地抄底？	stock
美国建国不过两百年，为什么会成为世界强国？	news_world
黄皮子讨封咋也不成，盖个草帽喝顿酒茅塞顿开，天天送药如愿以偿	news_story
日本人如何夺走中国烹饪的世界地位？	news_world
为什么台积电一个代工企业利润率在中国只输工行，还比苹果高呢？	news_tech
新妖出世，坐等加冕	news_finance
全媒体记者（大咖）聚焦尧治河 见证中国最美乡村新发展	news_travel
大连一方主场3-0击败广州恒大，取得中超首胜，他们取得胜利的原因是什么？	news_sports
廖英强被证监会处罚1.2亿，你怎么看？	stock
如何评价演员小张铎的演技？	news_entertainment
大多APP在评论区都不支持图片格式的评论内容，是不够刚需还是过于低频？	news_tech
现在最便宜的64G内存手机是1299元，未来10年，64G内存的手机能便宜到多少钱？	news_tech
HTC的手机质量怎么样，用的人多不？	news_tech
净网2018，打击网络黑色产业链	news_tech
苏州大学全国排名第13位不太可能吗？	news_edu
海通策略：市场估值已回到2638点 估值底已出现	stock
2019亚洲杯中国国足到底怎样做才能“夺冠”？	news_sports
中国古代有休假制度吗？	news_culture
内蒙古呼伦贝尔大草原好玩吗？几月份去好呢？	news_travel
吉隆坡机场回中国的时候，不是在免税店买的物品可以托运吗？	news_travel
最后一辆图坦卡蒙战车迁至大埃及博物馆	news_world
夫妻一方偷偷把房子卖了，还能追回房子吗？	news_house
叙利亚的前途在哪里？	news_military
出联：山里人，水里人，山山水水人中人，如何接联？	news_culture
孩子把别人推下楼后，家长是怎样处理的？	news_edu
15亿大案：荐股骗局大曝光 财经主持人操纵39股	stock
十岁那年，他大意拨熄了奶奶的引魂灯，结果愧疚一生	news_story
独爱斐济的10个理由！让你彻底徜徉在浩瀚蓝色的天堂度假胜地	news_travel
瓦基弗银行3:2逆转意大利冠军，晋级欧冠决赛，距离全满贯又近了一步，怎么看？	news_sports
王者荣耀：英雄池中必须有这两名英雄，才是一名好的辅助玩家	news_game
你去纳米比亚花了多少钱？15天左右，人均2W够吗？	news_travel
人民日报：有些贫困户畏难情绪重 需补精神之“钙”	news_agriculture
到2018年5月为止，有哪些游戏被新闻正面报道过？	news_game
贵州六盘水的这几个景点，错过一个你都会觉得可惜！	news_travel
5月6日孝感房产网签22套 成交均价6544元/㎡	news_house
日本天皇的混乱生活，爷孙各自看上对方的妻子	news_story
市场比较认可两本理论，《波浪理论》《缠中说缠》大家对这两本理论有什么深入的见解？	news_finance
知名证券节目主持人廖英强操纵股票 被证监会罚没1.29亿元	stock
在昆明月薪3500，怎么买房？	news_house
一个只有六户人家的偏远山村，只见到三户，看看都拍到了些什么？	news_agriculture
力哥爆料：如果有时光穿梭机，你最想见谁？马云想见的是他们	news_tech
劲客试驾体验记：明明可以靠脸吃饭，却偏偏要靠实力！	news_car
中国自己的“球王”：22岁新星戏耍恒大3国脚太强悍！	news_sports
北大最有名的建筑之一，共产党早期组织在此成立，影响毛主席一生	news_edu
陈冲出席活动，网友：脖子上的项链非常精美！	news_entertainment
林徽因拒绝徐志摩而选择梁思成为终身伴侣的原因是什么？	news_culture
上联：月下清贫花富贵，如何对下联？	news_culture
中国和波黑互免签证协定将于5月底生效	news_world
旅行青蛙能取代吃鸡吗？	news_game
快乐大本营谢娜回归众人都发文欢迎 为什么独独吴昕没有动静？	news_entertainment
淘汰恒大也保不住曼萨诺，保级战酿1-5惨案，球迷怒吼下课！	news_sports
李小璐出席某活动，网友：你不用撩裙子也有人找你做头发	news_entertainment
为什么有人说前置指纹优于后置指纹？	news_tech
上专科选什么专业好？	news_edu
有哪些让人感动的语句呢？	news_culture
房产证上没有男方名字，男方的私生子能继承房产吗？	news_house
强势股持续涌现 三维度布局化工板块	stock
58同城中甲：替补登场显神功，黄希扬一展皮尔洛神迹	news_sports
萧山古墓群损毁严重 文物贩子每块200元兜售汉墓砖	news_culture
什么是可转债，为什么最近这么流行？	stock
辽宁舰航母的斜角甲板是14度，国产航母的斜角甲板是12度，两度之差有何不同？	news_military
光头后的男明星！李晨可以拍科幻片！谢霆锋颓废感刘德华更加帅气	news_entertainment
四川游客张某带着六名女子在三亚沙滩烧烤被撒沙，这事你怎么看？	news_travel
曼城主帅瓜迪奥拉确认亚亚·图雷今夏离开球队	news_sports
济宁市太白湖区碧桂园中央公园可以买吗？	news_house
中国限产，全球缺货，这家有机硅龙头必须关注起来了！	stock
本田思域将推出SI版，外观更偏跑车设计，碳纤维中控，依然搭1.5T	news_car
angelababy 一起去海边吹吹风「污」男神女神一起驾到	news_entertainment
买了这只股票让巴菲特赚了七倍，而散户却至今还在深套之中	news_finance
谭维维未婚夫陈亦飞发文报平安，还隔空喊话感谢老婆真幸福！	news_entertainment
农村葬礼，随了份子后菜没吃上，只喝了几口汤	news_agriculture
这一年，阿里巴巴要怎么打破“诅咒”，实现马云的新零售大梦	news_tech
如果美国总统特朗普辞职，会对整个世界带来什么影响？	news_world
15年过去了，《倚天屠龙记》演员颜值对比，有的似大妈有的如少女	news_entertainment
碧生源(00926)预计2018年上半年收入大幅下降 预亏2000万-3000万元	news_finance
以色列警告称如果战机被击落将会轰炸俄军事基地，你怎么看？	news_military
周末去哪儿？来安徽感受国家级绝美风景道	news_travel
启辰D60智联精英版分期付款要多少钱？	news_car
大三学生，最近书荒得厉害，有什么好看的书单推荐？	news_culture
印度一男子不顾劝阻要和熊自拍，被咬死，大家怎么看？	news_world
日内瓦国际汽车展览会	news_car
过完年从农村老家出来，一直没回家，想孩子了	news_agriculture
史诗级奇幻大片《阿修罗》将于暑期上映，吴磊领衔剧照流出	news_entertainment
音乐学学渣考研有多大的希望？	news_edu
为什么有些开好车的女生很漂亮？	news_car
旅顺二〇三樱花园缤纷花季	news_travel
从军中娇娃到赛场魅影 她便是这样的女兵	news_military
沈飞歼31正密集试飞，复合材料比歼20还高5%，隐身性更强	news_military
女友劈腿后，农民工跑到荒山当道士，从此断绝和家人联系！	news_story
《金粉世家》张琼姿女儿长期遭霸凌，如今身材大好，美艳成仙！	news_entertainment
2017年的巴菲特股东大会有哪些看点？	news_finance
有一“黑科技”我国已拔头筹，技术具有重要军事价值	news_military
盘点：拍戏坚决用原声的演员，蒋欣、王凯、靳东、张一山上榜！	news_entertainment
史蒂文斯神奇调整凯尔特人加时再胜76人，苏群：76人完了	news_sports
上联：野花无主为谁开，如何对下联？	news_culture
麦莉·赛勒斯去电视台录节目，她真是越来越美！	news_entertainment
考试，县级事业单位和公务员，应该选哪个？	news_edu
苏-57战机红场首秀，俄空军还让刚公布的杀手锏武器参加阅兵	news_military
《昆池岩》开启恐怖片热潮，今年的十大海外惊悚片你最期待哪部？	news_entertainment
想买7-9W自动挡二手车，有什么推荐？	news_car
股东代表诉讼应定额收取诉讼费	news_finance
震惊！LPL冠军下路首秀惨遭黄金奶妈双杀，Uzi：现在黄金都这么强	news_game
杨幂首次回应，一开口粉丝就炸了	news_entertainment
李小璐商演捞金，依旧靠露肉博眼球全程面无表情心情不好	news_entertainment
老婆3年还不怀孕，我强扭她去医院做检查，看到报告，我报了警	news_story
棋牌游戏运营：2018上半年棋牌游戏总结及展望	news_game
美国真的强大到可以在全球进行经济掠夺了吗？	news_world
军演时来敌人了怎么办？	news_military
京东市值3个月蒸发1200亿，为何屡遭机构唱空？	news_tech
张一山生日杨紫画画送祝福，网友提问直击灵魂：为什么都穿小裙子	news_entertainment
特朗普从叙撤军？原来是条阴险的诡计！	news_military
世乒赛夺冠后，刘诗雯调侃自己在职业生涯末端，两年后奥运会还能见到小枣吗？	news_sports
三十年河东三十年河西，美国人寻求的东西，在中国一个都不缺	news_world
为什么从1969年登月成功后再也没尝试登月? 在怕什么？	news_military
LOL：MSI投票成RNG战队秀？Uzi一个人把服务器给弄崩了	news_game
印度和巴基斯坦为什么会仇视？难道仅仅是因为英国人的小手段吗？	news_world
五一猪价继续下跌，小散户不倒闭，猪价就涨不上去？	news_agriculture
王者荣耀中吕布出闪电匕首、纯净苍穹或者无尽之刃哪个性价比或者效果好一点？	news_game
铜梁的房价是多少？	news_house
申万宏源：反弹渐次展开 中级行情有望	stock
从毕业到月薪过万，你用了多久？	news_edu
LOL如何不出高地赢下比赛？这件神装必备！	news_game
上联：桃花伴柳江湖远，如何对下联？	news_culture
皇马2大铁主力将无缘国家德比	news_sports
千古绝对！上联：“老牛吃嫩草”，下联太经典了	news_culture
为什么历史上没有一个国家能吞并中国？	news_military
大盘在明年2月份之前将以下跌为主，到哪个点位能够企稳？	stock
中国赠送马克思雕像在德国特里尔揭幕	news_culture
作为湖北的家人，你知道从湖北走出的明星有哪些吗？	news_entertainment
高考有多累？	news_edu
为什么是罗森便利店占领了上海的市场，而不是711？	news_finance
姚明的“奥运第四问”：盼00后运动员继续为国旗奋斗	news_sports
玉笛吹来美人风，如何赐句？	news_culture
中专学电脑编程好不好？	news_edu
王者荣耀：辅助开局这么做，准备6分钟投降吧！他绝对是个坑	news_game
考场微型小说阅读技法及实例解析	news_culture
保险关联交易监管法11年后大修 比现行规定有松有紧	news_finance
宁夏银川影视城好玩吗？	news_travel
今31岁身家过亿，是赵丽颖的绯闻男友	news_entertainment
为什么好多人都说儒家思想祸害中国？	news_culture
上联：青松无衣不惧冷，如何对下联？	news_culture
号称最安全的中型SUV，性能不输奔驰GLC和宝马X3，才36万元开回家	news_car
婆婆在牛棚意外去世，出殡那天，家中老黄牛撞向儿媳，惊到众人！	news_story
提供借款后立即要求支付利息属于 变相预先扣除利息	news_finance
怎么看微博大V爆料《王者荣耀》掉帧卡顿等问题，是因为手机品牌保护费交的不够？	news_game
海南琼中买的房子，限购政策只能卖给本县人，以后还能卖出去吗？	news_house
王者荣耀：妹子刚上铂金就被封号，理由很搞笑，网友却直呼好傻	news_game
林嘉绮出席发布会，网友：她的每一次转身，就没让我们失望过	news_entertainment
《我的世界》攻略：手游地图生存指南，沙漠雨林海洋大盘点（上）	news_game
军事上常用的炸药，除了TNT，还有哪些类型？	news_military
汽车发动机积碳问题真的不可避免吗？	news_car
联合国安理会改革废除一票否决权，会导致什么后果？	news_military
揭秘！为什么买新房找中介比去售楼处更便宜！	news_house
美军控制区内出现新的化武袭击，俄罗斯为何保持克制不去揭穿？	news_military
书法学习之77	news_culture
上联：仙山升明月，下联怎么对？	news_culture
男友听到我怀孕后失踪了，我和父母找到他家，我吓得瘫坐在地！	news_story
传媒行业：坚定看好传媒板块，建议补仓细分领域龙头	stock
lol现在哪个英雄单挑最厉害？	news_game
你愿意穿着汉服出门吗？	news_culture
女孩子去技校学什么专业比较好呢？	news_edu
西藏波密：千户贫困户获“脱贫保”	news_agriculture
雪迪龙这家公司的股价为什么一直走低？	news_finance
古装剧中那些男扮女装，第一个认不出来，最后一个至今无人超越	news_entertainment
汽车暴晒像蒸笼？越来越多司机装“太阳伞”，车内比开空调还凉爽	news_car
巴勒斯坦抗议者用弹弓击落2架以色列军用无人机	news_military
2019年亚洲杯分组抽签揭晓，中国队首夺亚洲杯的机会真的来了吗？	news_sports
若现代社会发生战争，普通家庭可做哪些简单准备？	news_military
我月薪两万你妈病重关我啥事，我就一分不出，不过就离婚	news_story
DNF最强预言家：15年的朋友看过来！你绝对想不到的……	news_game
刘诗雯戴罪立功取胜平野美宇为中国女乒拿到世乒赛冠军，怎么看待这场比赛？	news_sports
中学年薪50万全国招聘教师，被称为“掠夺师资”	news_edu
东北黄大仙洞被无知村民火烧，黄大仙不计前嫌继续保佑（原创）	news_story
以色列警告称如果战机被击落将会轰炸俄军事基地，你怎么看？	news_military
“姜太公在此，诸神回避”，不只是一句俗语，背后的意思很深刻	news_story
万孚生物：科金控股计划3个月内减持1%股份	news_finance
6旬庄稼汉凭一株红薯苗发家致富，一亩地挣到了10万元	news_agriculture
国产车推出高端线路品牌，性价比更高，车主反馈不错	news_car
香港浸会大学的国际新闻认可度在香港和大陆到底如何？	news_edu
拉卡拉、瑞和宝、随行付、立刷，大家推荐哪一款？	news_tech
巴菲特股东大会上的珠宝店、家具店、牛排馆和乒乓球赛	news_finance
企业家之殇 上市公司董事长选择自杀真相！	news_finance
如果特朗普遭弹劾下台，谁来接替当总统？	news_world
上海这家店生意火爆，大家排着长队只为了吃这道“湖南菜”	news_travel
怎么看微博大V爆料《王者荣耀》掉帧卡顿等问题，是因为手机品牌保护费交的不够？	news_game
德国飞行员纷纷选择提前退役，拦都拦不住，只因俄罗斯的疯狂飞行	news_military
如果你是一名教师，同意取消职称吗？	news_edu
从目前来看，特朗普是一个好总统吗？	news_world
研报精选：它凭借着80%的市占率望成工业4.0龙头！	stock
这一榜单乔丹也只能屈居第二 现役季后赛得分榜他已无可超越	news_sports
如何看待股票止损与死扛？	stock
后来的我们，不好不坏，你可以从任何方面批评，但它三观没有不正	news_entertainment
马克思是世界上最伟大的哲学家吗？	news_culture
明末出现那么多名将，大明为什么还是亡了？	news_culture
几百米之上的玻璃栈道，让人眼发晕腿打颤，游客绝壁凌空囧态百出	news_travel
未来房价会跌到什么程度？	news_house
上联: 残阳不语逐鸿雁，如何对下联？	news_culture
如何分析一家上市公司值不值得长期持有？	stock
如果日本国土滑向海沟沉没，要求中国人民收留，作为中国人你会接受日本人吗？	news_world
得寸进尺！沙特石油还涨！中国霸气拒买，沙特怕了：我是被逼的！	news_finance
山里女子招夫养夫 两个“丈夫”从未红过脸	news_story
英雄联盟：下个版本QDC玩法又回来了，拳头屡次削弱都没用	news_game
合阳县未来有什么发展？	news_finance
谁有好的微信头像可以分享？	news_tech
刘德华的吃相、刘晓庆的吃相、徐峥的吃相，最后一个最丑让人恶心	news_entertainment
王者荣耀：反野最厉害的四个英雄，最后一个比东皇太一还恶心！	news_game
唐汪镇全力提升旅游产业	news_travel
发酵床的垫料种类有哪些？哪种更好？	news_culture
作为俄罗斯总统，普京上台以来有哪些失误？	news_world
集市这些面食摊，摊子不大，但生意非常好！	news_agriculture
为什么美国总统出国访问都要空运专车？	news_military
业内：东莞升级调控预期较大 房价下降可能性存在	news_house
大家都说日本车不安全，你还会买日本车吗？	news_car
来一场说走就走的旅行，陕西宝鸡红河谷走起	news_travel
一次可毁灭200座城市，全世界仅有一艘，中国想要但被拒绝	news_military
王者荣耀里坦克出不出霸者呢？	news_game
从20%暴跌到0.8%仅用五年，三星手机为何会在中国遇雪崩式溃败？	news_tech
长线投资一般投资什么股票？	news_finance
上联：星繁风幽催叶梦，下联你怎么对？	news_culture
2018年的房价回是什么趋势？	news_house
40岁患癌美女为自己举办人生告别宴	news_story
网易——马化腾也打不死的小强，扫地僧般的存在	news_tech
WWE巨星究竟多有钱？约翰塞纳有私人车库，比WWE老板的车还多！	news_sports
上联：池畔蛙鸣，应知红短绿长，怎么接下联？	news_culture
自媒体大咖是如何利用自媒体赚钱的？	news_tech
远行吧！来一场想走就走的旅行	news_travel
超跑不输郭富城，有16块“8882”车牌，今年赚36亿，出门爱吃火锅	news_car
养家糊口的农村妇女千千万，能把特产卖成王的只有麻城这一个	news_agriculture
比特币BTC和比特币现金BCH同时上涨，两者是否互相影响？	news_finance
期限或变成无限！为何敢于对美说不？手握杀手锏和美软肋！	news_world
英国留下的种子发芽，东巴基斯坦独立的必然原因	news_world
小麦减产已成定局？3天内已有大面积降水，农民需提前做好准备	news_agriculture
杨子曾公开表示黄圣依没文化，岳母自爆家门疑为女儿讨公道！	news_entertainment
美媒：俄罗斯的苏-27战机令北约害怕	news_military
10篇微小说，短到极致，却动人到极致	news_story
生肖是按阴历还是阳历来算？	news_culture
无人机还敢乱飞？我军两架战机前往拦截！四人被抓！	news_military
唐河县文峰街道人大代表、政协委员检查指导辖区教育工作	news_edu
「早参」姚振华胜利大逃亡	news_finance
想玩恐怖游戏又害怕怎么办？	news_game
芝麻信用是怎么计算出来的？	news_finance
王者荣耀：李白界的人气主播，一个李白打出各自风采	news_game
和老公拍婚纱照，老公全程抱着我，拍完后，摄影师小声劝我说别嫁	news_story
孕妇生孩子没有疼痛感，医生：因为她孕期经常做一件事	news_story
一个无需解释的故事	news_story
王者荣耀如果双方都不打，只让小兵上，谁会赢？	news_game
现在农村人为什么都不种地了？	news_agriculture
郑州和西宁哪个城市更发达呢？	news_house
股票，期货配资有没有市场前景？	news_finance
高考分数在二本中段线，想报临床医学专业，有希望吗？	news_edu
开发商为什么急着把房子卖出去，而不是等到升值了再卖呢？	news_house
关于均线系统，有什么独特的、有效的见解跟设置用法吗？	news_finance
西安航空学院和西藏民族学院哪个好？	news_edu
大家身边的朋友都有几套房，你怎么看房地产的未来十年？	news_house
教师招聘重要考点备考之中国古代教育专题	news_edu
今年大豆要扩种，补贴大幅度提高哦！	news_agriculture
她自愿嫁给土匪，到了晚年依然如此惊艳！真想知道年轻时长啥样	news_story
波兰捷克等国欢迎美国驻军吗，为什么？	news_military
「上币公告」ABCC上线DASH、OMG	news_finance
我省2018年大学生志愿服务西部计划启动	news_edu
上联：江中鱼东游西藏，下联怎么对？	news_culture
四野在东北的武器装备是哪里来的？	news_military
蟹塘水浑浊的原因及处理方案	news_agriculture
手机挖矿app，数字币AIC、SKU	news_tech
未来大部分房价会跌，但这15个城市或最稳定，看看有没有你家	news_house
怎么样能直播迷你世界？	news_game
农村酒席上必不可少的东西，都在这里了！	news_agriculture
有什么唯美剧情的手机单机游戏？	news_game
爱你爱到骨子里的男人会有这3个表现，薄情的人装都装不出来！	news_story
五角大楼神秘办公室面临废黜 如今或让“第二神盾局”接管	news_military
为什么韩国、越南可以在几十年就把国家文字和语言更改了？	news_world
有了它之后，吉利服变成了自我欺骗，韦神女友都看不过去了！	news_game
欧洲最为惊艳的女间谍 死前仍精心打扮 前半生悲惨无比	news_story
高考加分政策出炉！今年连云港这些高考生可以享受照顾政策	news_edu
如何查阅股票基本面资料？	stock
龙虾养殖：用药不当，可能会导致龙虾大范围死亡	news_agriculture
面对考场作文中出现的一些突发状况，究竟该如何应对？	news_edu
2019亚洲杯中国国足到底怎样做才能“夺冠”？	news_sports
就冲这3个条件，红心猕猴桃卖的也要比黄、绿心贵	news_agriculture
自从玩了《绝地求生》以后，你感觉到自己身体什么部位明显变差了？	news_game
拒绝握手海因克斯 莱万多夫斯基究竟为何？	news_sports
怎么升级余额宝？	news_finance
国内投资3000亿用来做芯片，够了么？能不能打败高通和英特尔？	news_tech
打麻将你不懂技巧？麻将大师教你5个技巧口诀 打牌不会再输	news_game
科比他的一生之敌只有一个人，不是詹姆斯，那会是谁？	news_sports
巴中这个城市怎么样？	news_house
今年是个丰收年，世界上最大的水果，高速路上晒一晒！	news_agriculture
看过了那些大山大水，初见阳朔竟是这般感受	news_travel
怎样打开正确的教育方式？	news_edu
「昌图牧歌」2018年5月6日猪价监测预警	news_agriculture
一个人的微博账号透露了哪些信息？	news_entertainment
上联：寒山寺天寒地冻，下联？	news_culture
iBoy直播挂机惨遭LPL官方罚款一万元，打野螳螂或将面临封号？	news_game
赵丽颖为什么火？	news_entertainment
女排北仑集训，被寄予厚望的小将李盈莹正在打磨哪些技术环节？	news_sports
黑科技领路人！三星S10再曝：100%真全面屏稳了！	news_tech
崇义筑牢健康扶贫“四道保障线”	news_agriculture
「新车」国产奔驰A级三厢正式亮相 豪华紧凑型轿车的新标杆	news_car
初夏方好，小荷初露，一起来读那些美不胜收的咏荷经典诗词	news_culture
加沙发生爆炸致死6人	news_world
是走还是留？15.60元的成本，只怕是无影脚的票，第二天高开出货	news_finance
浑江区有这样一个地方，每到六、七月份竟能美成这样……	news_travel
李嘉欣价值近6亿的豪宅曝光，网友：过的像电视剧	news_entertainment
“整容狂人”的审美，恕欣赏不来	news_entertainment
DNF：体验服光环装备改动，部分副本中无效，已经彻底凉了！	news_game
十几年老摩托更换套缸，重新焕发青春！换缸过程全图记录	news_car
杜特尔特又说话了，估计会扎特朗普的心！	news_military
中国楼市不断上涨，李嘉诚为什么加速撤离中国楼市？	news_house
马夏尔要去切尔西？可以商量，不过穆里尼奥的要价是4000万加威廉	news_sports
杨幂黑色礼服秀性感香肩，精修图温婉动人，无精修的你觉得怎样？	news_entertainment
义乌造的“睡觉神器”，连去酒店开房都不需要了，老司机百用不厌	news_car
日本的93式氧气鱼雷威力为什么那么大？	news_military
错过了楼市，错过了比特币，下一个风口会是什么？	news_house
谢娜三喜临门，何炅送祝福，吴昕送祝福，只有沈梦辰不一样	news_entertainment
千姿百色弄秋光，求对子？	news_travel
哈萨克斯坦允许美国建立军事基地，如果哈彻底倒向美国，对俄罗斯究竟有多大威胁？	news_world
妻子智障遭村里人欺负扔石子，丈夫带她隐居深山，还添个健康儿子	news_story
黄金周评：非农意外利多黄金维持震荡，多头发力上方阻力重重	news_finance
日本的发动机为什么那么先进？特别是摩托车的发动机？	news_military
第三届全国基础教育信息化应用展示交流活动在京举行	news_edu
世界上最奇葩的水果，你未必都见过，吃过其中的一种我就服你	news_agriculture
大西安2018新开业的41座商业体展示！敢问这是几线城市发展实力？	news_house
我们的世界有多少个国家？	news_world
中国人一年不买苹果手机，苹果会破产吗？	news_tech
中国赠送马克思雕像在德国特里尔揭幕	news_culture
保险的起源与大航海时代	news_finance
中南财经政法大学分专业招生计划、录取分数	news_edu
郑州买房除了落户郑州还有其他途径吗？	news_house
豪车体验师：你这辆车与豪车之间的距离，只差了几个高科技车品	news_car
重庆黄葛树种植基地在哪里？	news_agriculture
大众怒了，新车完胜雅阁，配2.0T加四驱，仅售12万，还买啥凯美瑞	news_car
拿了98K因枪法太烂，一枪都打不中？教你称霸绝地求生的独门绝学	news_game
一脚油门奔驰变废铁 车子从20余米高山坡滚下	news_car
如果2018年房价趋稳，2019年是否会赢来爆发？	news_house
“多管闲事”的黄皮子	news_story
房价只涨不跌是正常？专家预测：20年后房价达到80万每平	news_house
王俊凯竟要挑战这么惊险的人生第一次！高能量体质体验，勇攀高峰	news_entertainment
区块链人才紧缺，全球顶尖高校纷纷开课 中国八家高校搭上专车！	news_tech
盐城市大洋新村会拆迁吗？	news_house
西安交通大学筑梦社微宣讲团赴延安宣讲	news_edu
在日本，穷人的生活是怎样的？	news_world
篮球正负值是什么意思？	news_sports
美国为何要打叙利亚？	news_military
为什么很多在工厂上班的人，甘愿每月拿着几千元的固定工资？	news_finance
NBA球队是否真的有”相生相克”？	news_sports
泰国前任总理，英拉年轻时到底有多美，上学时追求者无数！	news_world
县区丨东安：扎实推进阳光体育 有效增强学生体质	news_edu
我在浙江鞋厂上班月薪8000有人羡慕不已，我却感到很失落	news_story
从20%暴跌到0.8%仅用五年，三星手机为何会在中国遇雪崩式溃败？	news_tech
每个人身体里都住着3个神仙，每天造谣生事	news_story
陈冰出席发布会，网友：这二郎腿翘的也太有个性了吧	news_entertainment
用“女儿裸照”赚钱，这种也配称之为“妈妈”？	news_entertainment
跳到水里能躲子弹吗？	news_military
亚洲杯分组国足抽得上上签，国足就一定能出线吗？	news_sports
男子瘫痪后要与妻子离婚，妻子唯一条件：离婚不离家	news_story
腾讯没有梦想引发轰动，马化腾刘炽平亲自回应！你赞同谁的说法	news_tech
红信APP真的可以领红包？	news_tech
男子在餐车就餐遭拒绝，扬言要曝光乘务员，你怎么看？	news_world
车主随即抽中苏A88888，上牌花费不到一千，最终却放弃了这块牌照	news_car
上联：秋水映月一船梦。如何对下联？	news_culture
10城房价跌回一年前，楼市资金将会转战股市吗？	stock
教师资格证面试试讲如何分配时间？	news_edu
公司注册资金500万，在税务登记时要缴纳多少资金？	stock
上联：往事成空一梦中，下联怎么对？	news_culture
夏天太热了，只要有多余的时间很适合去这几个地方漂流，景色清幽	news_travel
骑士官宣一消息，詹姆斯做出回应，泰伦卢成最大赢家	news_sports
铜陵有哪些大型企业？	stock
日本目前能修改和平宪法吗？	news_world
猛龙为什么又输了？	news_sports
“股神”巴菲特被一个8岁女孩问倒了！甚至怀疑自己买错股票	news_finance
郑眼看盘：医药券商白酒为何脉冲式上涨？	news_finance
绝地求生刺激战场：跑毒载具选哪个？这些载具参数你必须懂	news_game
雷克萨斯科幻车亮相，造型更激进，剑指宝马X6	news_car
什么软件应用能下载各种vip视频电影？	news_tech
大学生毕业在即，准备二战考研，但是学校逼着签三方协议，这样合适吗？	news_edu
在腾讯和阿里刚上市时分别购买100股它们的股票，现在将获利多少倍？	news_finance
有100万，用什么方式的理财，如何才能快速增值？	stock
撑着小船来娶你！悠悠隆庆，用500年岁月诉说水乡故事	news_agriculture
武当掌门游玄德在生活中。比如街斗对阵泰拳王西提猜，结果会怎样？	news_sports
奥尼尔:艾科麦佛鲨VS维韦杜詹霍，谁是更强战队？	news_sports
预算12万，荣威rx5和长安cs75买哪个好？	news_car
卖早餐的小夫妻	news_story
资管行业面临大洗牌 保险资产配置重心往哪转移？	stock
实行房产税和遗产税之后小产权房怎么办？	news_house
为你的情怀买单！JEEP全新指南者震撼来袭，霸气侧漏，售价感人	news_car
买了高层西边户会不会夏天很热，会受到什么影响？	news_house
学校宿舍一般几人一个比较好？	news_edu
日落霞飞苍山远，求下句？	news_travel
美国为何有底气在世界上挑起战争？	news_military
日本的自杀率为什么这么高？	news_world
说故事：投胎是个良心活儿！	news_story
头条号得粉丝得未来	news_travel
普京前妻结婚了吗？	news_world
180506 恭喜熊梓淇微博粉丝数突破900W大关！	news_entertainment
第一杀手白宝山杀人纪实 下手实在太血腥一	news_story
买车上牌，还要多花近10万！国内车牌最贵的5个城市	news_car
詹姆斯38分压哨抛投绝杀 骑士3-0猛龙拿到赛点	news_sports
玉米大小苗严重影响产量，及时采取这些措施，减少损失多赚钱！	news_agriculture
全球十大防空导弹盘点：中国只有一款上榜 排第7	news_military
胡彦斌和女选手yamy撞脸俞灏明：这是不是你妹妹？	news_entertainment
上联：乳燕翻飞照碧水，如何对下联？	news_culture
网易云热评，每句都是一个故事：我希望她30岁还没嫁，但不想成真	news_story
合伙开店如何转让股份？	news_finance
职称评审期间，可以换工作吗？	news_edu
张若昀和胡一天都很帅气，他们不撞脸，却撞痣了	news_entertainment
上港1-2输给国安的比赛中，国安后卫刘欢的手球，没有判罚点球，是不是误判？	news_sports
以色列警告称如果战机被击落将会轰炸俄军事基地，你怎么看？	news_military
德国男乒3:2艰难战胜韩国，挺进决赛会师国乒，中德乒乓大战胜算大吗？	news_sports
何享健卖“美的”，为何急于这11亿？	stock
有什么办法可以下载酷狗里面的收费歌曲呢？	news_tech
震荡行情和单边行情如何区分？	news_finance
夏季你是不是这样洗车？难怪新车越洗越旧！全搞错了，快来看看吧	news_car
全世界最出名的猫，它数第二，没人敢数第一了吧	news_travel
将SUV和轿车融合在一起的新款沃尔沃，值得买吗？	news_car
三本的学生一定会比211、985混的差吗？	news_edu
这就是西藏！	news_travel
故事：动物报恩，十年不晚，樵夫心善得到老虎的保护	news_story
谢楠带儿子现身，吴所谓一身潮装对镜卖萌，网友：一点都不像吴京	news_entertainment
她是女摇滚第一人，为恩师堕胎甚至想过自杀，如今不计前嫌成好友	news_entertainment
这样的女朋友，再漂亮也要说分手！	news_story
二战时候，如果美国不参战，现在会是什么样？	news_military
二战中的不列颠空战对德国来说是否具有战略意义？	news_military
三无人员申卡难，掌握申卡技巧快速下卡！	news_finance
如果发生世界大战，你会怎么办？	news_military
美国建国不过两百年，为什么会成为世界强国？	news_world
中国故事大会第二季冯提莫是第几期，冯提莫1500万粉丝背后的故事	news_entertainment
人死亡时，在咽最后一口气时会难受吗？	news_story
惊恐“套路贷”是如何毁掉一个人的？	news_finance
马上到美国留学的大学男生，对象找哪的合适？	news_edu
媳妇拿桌子供阎王，求得了十年寿命，恶毒婆婆竟也来效仿	news_story
如何看待“自由搏击与传统武术谁厉害”这样的问题？	news_sports
女司机开夜车跑长途，只带充气床还不够，后备箱带这些车品更安全	news_car
上联：彼岸花开处，下联怎么对？	news_culture
当今谁是世界上强国？	news_military
一个梦幻平民老玩家的商人之路！——5	news_game
江西高考重大发布！关于录取和志愿填报，看这一篇就够了！	news_edu
纪念伟人，马克思诞辰200周年！	news_culture
几乎每一个银行工作人员都劝说顾客，不要把钱存入余额宝，对此你怎么看？	news_tech
论雅俗共赏，我只服他	news_culture
以色列警告称如果战机被击落将会轰炸俄军事基地，你怎么看？	news_military
为什么广西北海地少人少，经济总量却比南宁高？	news_travel
这种树木你认识吗？农村的山坡上到处都是，它是一种名贵木材	news_agriculture
能够连接印度洋和太平洋的泰国克拉运河项目是否已经开工，一旦建成对新加坡有影响吗？	news_world
《坦克世界》里的KV85怎么玩？	news_game
上联：窗前清风拂月，有哪些合适的下联？	news_edu
这种“野味”农村很常见，扔一个，长一片，现在卖到15元一斤	news_agriculture
《狂野飙车8》破解版在哪下？	news_game
前妻结婚了！我托人送去1万礼金，晚上收到了她发来的六字短信	news_story
如何评价文章《腾讯没有梦想》，腾讯是否真的在丧失产品能力变成投资公司？	news_tech
想买SUV？这些将要上市的新车绝对有适合你的	news_car
如果证实反政府武装使用化学武器，美英法会被追责吗？	news_world
墨汁里可以加酒吗？	news_culture
Angelababy又接新剧，这次男主是邓伦和朱一龙，你期待？	news_entertainment
《王者荣耀》梦奇和铠单挑谁更厉害？	news_game
2018互联网创业可行吗？	news_tech
建房屋第一层最高可以多少米？	news_house
克洛普：希望凯塔能迅速起到作用，可能会邀请他去基辅	news_sports
央视聚焦国产航母诞生地，位于武汉的这个研究所实力刷屏	news_military
出联：落英缤纷凌空扬，谁知何处思故乡，如何接联？	news_culture
房产税最新消息，专家：与房价扯不上一毛钱的关系，别等了	news_house
2.5平的电线可以承受多少电器？	news_tech
厨师的出路在哪里？	news_world
24+5+4，第一新秀换人！20岁天才刷爆72年历史，小詹皇被他打爆	news_sports
中国游客到北海道旅游，“冒死”吃帝王蟹 吃到扶墙而去！	news_travel
美军终于怕了：彩虹无人机已实战干掉300多目标	news_military
土地承包期延长至2057年，农村新增人口如何获得土地？	news_house
「滚球体育APP」北京人和vs山东鲁能直播分析和预测推荐	news_sports
2018宅基地新动作：满足这4个条件的农民，可进行分户	news_agriculture
网传《马卡报》披露，内马尔希望加盟皇马搭档C罗，可能性有多大？	news_sports
怎么看微博大V爆料《王者荣耀》掉帧卡顿等问题，是因为手机品牌保护费交的不够？	news_game
咸阳和西安哪个城市的历史更悠久？	news_travel
四川游客张某带着六名女子在三亚沙滩烧烤被撒沙，这事你怎么看？	news_travel
奇瑞汽车使用的CVT变速箱质量如何？	news_car
关于均线系统，有什么独特的、有效的见解跟设置用法吗？	news_finance
京A88888到底是谁的车？真相浮出水面，看图知道原来是他！	news_car
小米雷军和格力董明珠赌约到期：全国人民作证的十亿赌注算数吗？	news_tech
瑞典世乒赛中国女队夺冠，如何看待新闻发布会上石川佳纯充当中国翻译？	news_sports
58同城中甲：下半场的卓尔惹不起 他们这一数据冠绝联赛	news_sports
什么样的军事条件才算得上是军事大国？	news_military
龙华新区观澜11栋带花园《福星家园》均价9800单间23万起可分期	news_house
期货交易到底难在哪里？	news_finance
老将内内的出场时间骤然增加不少，而安德森跌出轮换，德帅此意为何？	news_sports
父母是玄幻小说迷，给宝宝起的名字，爷爷直呼受不起	news_story
《甄嬛传》中安陵容这么乖巧、听话，皇帝还对安陵容如此绝情？	news_entertainment
世界第一伟人是谁？	news_travel
一款最适合群众的房车｜实拍金杯海狮C型房车	news_car
如果美国打伊朗，最快可以多久解决战斗？	news_world
美国为什么害怕自己出售的武器被用来对付自己？	news_military
这个夏季十分常见的野菜，吃起来像苋菜一样滑滑的，略有些酸！	news_agriculture
房价从3万跌到1万，这绝对是个例！	news_house
这次叙利亚战争后，叙利亚还能复兴吗？	news_military
大众集团提高电池交易量至480亿美元，或与特斯拉相同的市场容量	news_car
年收入10万，四口之家的普通饭菜	news_story
你爱占便宜的样子真丑	news_story
游戏设备大升级，助你畅快吃鸡	news_game
如果没有普京的出现，世界格局将会变成什么样？	news_world
商标转让和商标变更一样吗？不一样吗？	news_finance
《爸爸去哪儿6》嘉宾已经确认阵容强大颜值超高，网友：还有吴京？	news_entertainment
结婚前去女友家见家长时，岳父曾给过你什么样的下马威？	news_story
争强不服弱的潘金莲：和小厮闹矛盾，又同母亲吵架，再享鱼水之欢	news_culture
低调多年，赵丽颖哥哥终曝光，长得帅零绯闻，身家不比赵丽颖少！	news_entertainment
湖北宜昌：大雨之后，天空酷似水墨画！乡村农房相映美！	news_agriculture
世界各国的“国菜”,法国鹅肝，日本生鱼片，中国国菜我服了	news_world
炉石传说：这套青玉萨在狂野环境胜率高达67%，你还不来试试？	news_game
迷你世界移动墙怎么做？	news_tech
李嘉诚这次火了，投资51亿，新车颜值不输特斯拉，董明珠都羡慕！	news_car
为什么早市蔬菜那么新鲜？	news_agriculture
「原创」他最常吻我这里，算是爱我吗？	news_story
联想五大优势构建直面万亿市场的新业务模式SIoT	news_finance
如果《我的世界》和《迷你世界》动用所有力量“开战”会怎样？	news_game
千古爱情故事系列之：不思量自难忘——东坡与王弗的爱情故事	news_culture
中考必考题之旋转（王老师每天一讲）	news_edu
德罗赞连续13场季后赛面对骑士没有投进三分	news_sports
《王者荣耀》韩信偷鲲这个梗是从哪里来的？	news_game
勒布朗已是美国各大媒体公认的历史第二人，他与乔丹的差距究竟还有多大？	news_sports
欠钱不还的人是什么心态？有钱也不愿意还是什么心态？	news_finance
故事:师徒上山打猎，遇上四鬼抬棺，师傅大喊:“快脱裤子！”	news_story
民间故事：孟婆的传说	news_story
丁海寅C位被骂，对比金秀贤螃蟹步，网友群嘲：想红想疯了！	news_entertainment
斗鱼绝地求生黄金大奖赛F组第一天，numb发挥出色，双连鸡	news_game
17shou在Kakao服被封禁！你怎么看待这件事？	news_game
燕郊房价还会涨到调控前的水平吗？	news_house
投P2P本金加12%利息全打水漂 后来我开始研究贷款	news_finance
论饰演妲己，林心如远不如范冰冰，但是最经典的还要数这个人	news_entertainment
两所民办高等非学历教育机构不合格	news_edu
就业强劲通胀温和 美股大幅收高道指涨近200点	stock
“全球第一”的宁德时代，值1300亿吗？	stock
顶级游资的操作手法是怎样的？	stock
黎伟明将与法意艺术家在深圳联展	news_culture
美国海军重建第二舰队 遏制俄罗斯海上力量扩张	news_military
你怎么看待以色列总理出席俄罗斯5月9日的阅兵并会晤普京？	news_military
怎样防治小麦秆锈病？	news_agriculture
大货车司机讲大实话：“为什么我们不踩刹车”！	news_car
大盘一片绿色，指数是如何做到创新高的？	stock
创业者应该掌握的创业理念和方法	news_finance
兰州率先“松绑”限购透出哪些深意和动向？台州又将会如何呢？	news_house
产粮大县的田野“四则运算”	news_agriculture
世乒赛女团决赛，世界第一快刘诗雯2:3爆冷输球。你怎么看？	news_sports
假如有个好产品，如何找一个好的营销团队？	news_tech
《创造101》口碑不敌《偶练》，槽点满满，三期下来你记得谁？	news_entertainment
龚方雄：BAT回归将加速中国资本市场的机构化和国际化	news_finance
为什么越来越多的人喜欢去农家乐，因为他们生产的都是无公害蔬菜	news_agriculture
北师大版一年级数学期末综合复习题，非常实用	news_edu
美国现在有几位前总统健在？	news_world
民间故事：老人每天与一陌生老头下棋，跟踪后发现竟与王八坑有关	news_story
瑞安雷诺兹分享死侍复仇者拒绝信	news_entertainment
鲁能队员的身高	news_sports
1.0T思域怎么样？适合家用吗？	news_car
深山发现的紫薇树桩，村民看了无可奈何，殊不知做成盆景身价翻倍	news_story
深夜，老公给我发来一张照片，打开一看，里面的内容让我恶心想吐	news_story
在晴雯不改变自己性格的情况下，如何改才能变自己的命运？	news_culture
改装汽车排气管，会增加动力吗？	news_car
全新DS7起步不到21万，1.6T+8AT，远超GLA宝马X1	news_car
夏季暴晒很伤车！精明领导这样做，汽车寿命多延续5年，真凉爽	news_car
单身妈妈的独白：高三儿子为什么这么讨厌我？	news_story
物业公司的服务水准非常烂，该怎么解决？	news_house
图-160战略轰炸机如今还是世界一流轰炸机吗？	news_military
有什么好玩的天文游戏？	news_game
证券时报：港股“独角兽”股票频频破发的启示	stock
刷完抖音完好想好想去南宁！	news_travel
上联：乱石穿空今夜雨，如何对下联？	news_culture
增值税下调后，小规模纳税人开票如何处理？	news_finance
周口未来房价怎样？	news_house
让你笑喷的鬼笑话	news_story
农民注意！2018年城市里的农村人要想“回农村”，可参考以下标准	news_agriculture
总书记点赞的茌平耿店村，青年微信群里在聊啥	news_agriculture
4000家农资店齐努力，农资拒赊风暴无人能阻！	news_agriculture
贵州省遵义市湄潭县辖区内旅游景点简介	news_travel
乡村全面振兴将在大中城市率先实现	news_agriculture
新买的电脑只有一个C盘，如何增加分区？	news_tech
实拍：被孙子带“坏”的爷爷奶奶，老人深陷其中却幸福到不能自拔	news_story
刘诗雯首负日本因策略不当？8年磨砺自我救赎，刘国梁赞她这一点	news_sports
石家庄铁路职业技工学校2018年招生简章	news_edu
巴菲特，一生成功投资的最大秘密	news_finance
杭州哪里还有“1万+”的新房？优先选择哪一个？	news_house
相比起大庆的工资水平，你觉得大庆的房价高吗？	news_house
黑龙江最富有的三大家族，首富是陕西人，排名第三的他是黑龙江人	news_finance
韩国有枪战游戏，美国有刀塔游戏，中国有哪些游戏遍布世界？	news_game
他出道23年，演技不输孙红雷，因为名字太难让人记住，就没红起来	news_entertainment
证金公司会大量买入哪类创业板股？	stock
辛弃疾和党怀英的分叉路口	news_culture
拆迁中，理由一定要实事求是，以免弄巧成拙	news_house
上交所发布新规，将限制“游资”在市场上的强势抢筹与封涨停行为，怎么看？	stock
上联：草根登上星光道，怎么对下联？	news_culture
尼斯湖不仅有传说中的水怪，还有美不胜收的自然风景	news_travel
深圳房价迎19连跌！上月跌6元 这月再跌16元	news_house
《红楼梦》里，有哪些角色长得像林黛玉？	news_culture
曝限薪令最快在夏窗出台 恒大重庆或成最大受害者	news_sports
5月中旬，小麦用什么药？	news_agriculture
二战维京师弹尽后用牙齿和拳脚死扛苏军	news_military
作为俄罗斯总统，普京上台以来有哪些失误？	news_world
护照有效期不足6个月能去普吉岛吗？	news_travel
剪除病叶、卷叶究竟为啥？为什么连杂草都要清理	news_agriculture
未来房价会跌到什么程度？	news_house
烟火四起，俄罗斯家门口就迎来16国大军	news_military
艺术在进化过程中有什么用？	news_culture
瞭望刊文：房地产税改革渐行渐近 还需突破四个阻力区	news_house
20万上下SUV的，哪款比较好？	news_car
战事升级！普京正式授权驻叙俄军“核武反击”!	news_world
特朗普为什么要跟伊核协议较劲？	news_world
古诗词美文书法欣赏——游子春衫已试单，桃花飞尽野梅酸	news_culture
四川华蓥：荒山荒坡结出“金蛋蛋”	news_agriculture
娱乐圈不吸烟的乖乖男，马天宇张艺兴上榜，他因不吸烟有不老容颜	news_entertainment
《王者荣耀》的哪个英雄或者哪个技能最让你怀念呢？	news_game
川藏线旅游可以选择商务车吗？	news_travel
金庸笔下的男主角谁最厉害？	news_culture
中国赠送马克思雕像在德国特里尔揭幕	news_culture
第一次车臣战争，俄罗斯面对小小的车臣为什么损失惨重？	news_military
你感觉哪个是天津有代表性的美食？	news_travel
如何看待人物《奥数天才坠落之后》一文以及付云皓的回应？	news_edu
有50万的资金买车还是买地？	news_agriculture
全球最顶尖的 无人机	news_military
上海国际摩展Honda发布新款电动车	news_car
给女儿代孕的妈妈（现代故事）	news_story
鲁能0-0客平人和，错失登顶良机	news_sports
叙利亚战争，美俄第一次军事冲突事件回顾！	news_military
1699的魅族m15和1268的魅族pro7标准版该选哪个？	news_tech
落地价十七八万，适合二十来岁年轻人开的中型车有哪些？	news_car
我带着儿子再婚，新婚老公拿出一张银行卡，我连夜带着儿子离开！	news_story
吕布到底爱不爱貂蝉？吕布死后，貂蝉去了哪？	news_story
聪明男人都会买裸车，再装上这些不贵有档次的车品，开出去倍有面	news_car
预算50万左右，雷克萨斯ES、宝马五系、奔驰E级、奥迪A6这几款车应该怎么选择？	news_car
缅甸帕敢矿区再发山体滑坡 已致至少12人死亡	news_world
没有爱，就没有教育！江门开平一幼儿园收到家长亲笔写的“情书”	news_edu
房屋被征收宅基有补偿吗？	news_house
4月份济南这些热门楼盘拿到预售证！获批项目房价一览	news_house
彭祖活了八百八，却因为好奇心丢了性命	news_story
为什么暴雪不把dota做成手游？	news_game
2018年款iPad怎么样？用过的人还会选择安卓吗？	news_tech
温室大棚的选择，不求最贵只求更对	news_agriculture
夜已深，望星空，追忆似水年华	news_story
大盘跳水的时候个股跌停板一直没封死，庄家的这种行为是酝酿的什么阴谋？	stock
发誓加入中国国籍的黑人拳王阿迪萨亚为什么离开中国了？	news_sports
外媒称海南将成中国对外开放新窗口：繁荣或超香港	news_travel
开弓没有回头箭，下句怎么接？	news_culture
天南地北怀化人│刘代全，精心打造文化“酉庄”	news_agriculture
上联：层层叠叠多多彩，如何对下联？	news_culture
上联：半床明月增寂寞，下联怎么对？	news_culture
假若所有散户都空仓，A股会如何走？	stock
售价超过600万的库里南还不算贵？这几款车恐怕一般土豪也吃不消	news_car
手残可以做游戏实况视频吗？	news_game
竹林套种大球盖菇优质高效栽培技术	news_agriculture
我是天水人想去西安买房定居，我的选择正确吗？	news_house
雅阁，凯美瑞和天籁的后期费用，大约都是多少钱？	news_car
您也辛苦了！泰伦-卢新闻发布会上大口饮水	news_sports
机油滤芯有一次性和可换纸滤芯的，为什么有设计区别，哪种更好？	news_car
文化周刊｜中国传统村落保护（海南）高峰论坛儋州举行	news_agriculture
「学技术」eStarPro.星辰裴擒虎爆发出装铭文推荐	news_game
《DNF》玩家：玩了三个号实在有点玩不动了，该舍弃哪个号呢？	news_game
家里有空地，不如种几棵果树，随摘随吃，吃都吃不完	news_agriculture
普京在刚上台时说要带领俄罗斯成为强国，就目前的形势来看，俄罗斯是否成为了强国？	news_world
未来房价会跌到什么程度？	news_house
股票增发和股票回购是正好相反的两种操作吗？	news_finance
首家军工科研院所转制获批鼓舞板块人气	stock
“花笑夕阳暮”下一句怎么接？	news_culture
王者荣耀里钟馗的钩子和百里玄策的钩子哪个更可怕，你更怕哪个？	news_game
假如回到农村生活，你会怎么养活自己？	news_agriculture
全国牛价又跌了！	news_agriculture
以玉定情，始结同心	news_culture
上联：粗茶有真味，下联如何对？	news_culture
七栋功能齐全别墅，最后一栋就差一个好（壕）房主	news_house
世界上最贵的手动挡轿车 没有安全气囊ESP 比奔驰S级还贵	news_car
菲律宾众议长表示应废除联合国，建立亚洲联合国，有何深意？	news_world
小说：我是阴年阴月阴时出生的人，是最后一个阴阳师	news_story
为什么说“不惜一切代价发展芯片产业”是危险的？	news_tech
亚洲地理位置最好的国家	news_travel
炒房是不是已经向小县城转移了？	news_house
很多散户资金量不多，却同时持有四五个，甚至十几个品种的股票，这样真的好么？	news_finance
天空一声巨响！我国在美眼皮底下击沉万吨军舰，航母后撤1000公里	news_military
小心“伪”学区房的陷阱	news_house
读书是如何改变一个人的命运的？	news_edu
何老师希望谢娜下辈子是他的“路人”	news_entertainment
美国527委员会究竟是什么，有什么作用？	news_world
Instagram上线支付功能可在APP内直接购物，为什么社交软件巨头纷纷布局电商？	news_tech
不算吃亏（民间故事）	news_edu
码商的福音！1688把货源搬进支付宝二维码 进货收钱一“码”事	news_tech
到广西旅行这几个神秘秘境，让人身临其中，仿佛世界在脚下	news_travel
苏州大学全国排名第13位不太可能吗？	news_edu
持股比例仅次于雷军，如何评价小米二号人物林斌？	news_tech
两位时尚辣妈，baby体重45.1，昆凌体重43.8，身材保持得真棒！	news_entertainment
最美大众，CC强势回归，网友：更加漂亮了	news_car
奥数天才当教师，人生换轨，何来坠落	news_edu
阴阳师：这几位SSR基本全靠碎片合成 不是怕脸黑而是实用度太高了	news_game
动漫cosplay《王者荣耀》牛一样的眼睛浓妆甄姬—游园惊梦	news_game
小产权？公寓？没名额该如何买房？	news_house
上句：麻将桌上观君子，如何接下句？	news_culture
一套150平二手房，售价86万，过户税费额外需交多少钱？	news_house
继詹皇、King James、老北京之外，詹姆斯又得一个新绰号	news_sports
2018年美国中期选举，你认为特朗普会下台吗？	news_world
逾50万人新落户西安！这些城市都在推落户新政，楼市涨价在路上？	news_house
丢一场赢一场，今天刘诗雯在世乒赛女团决赛的表现值不值得表扬？	news_sports
贷款买房前 你是否知道这几大误区了呢？	news_house
这货不到10万，很适合五一出游，空间也满足要求，值得入手！	news_car
旅行时和异性拼房是一种怎样的体验？	news_travel
军工行业11个世界500强大型企业集团资料整理	news_finance
上联：北京北，南京南，如何对下联？	news_culture
爆款RPG《东方梦符祭》爽快抽卡停不下来	news_game
被诅咒的德川家族！每隔3代或4代就一定会断绝子嗣，简直有毒！	news_story
世界上岛屿最多的湖-杭州千岛湖	news_travel
长汀连城两日游，走过古城，探访培田古民居，登顶冠豸山	news_travel
旅行时和异性拼房是一种怎样的体验？	news_travel
以色列警告称如果战机被击落将会轰炸俄军事基地，你怎么看？	news_military
既然股票分红要除权，那A股分红有什么意义？	stock
以色列警告称如果战机被击落将会轰炸俄军事基地，你怎么看？	news_military
山坡上的房子	news_agriculture
日本选出全球最标致的五大面孔，中国上榜一人，不是范冰冰而是她	news_entertainment
五月份是买房的好时间吗？	news_house
你愿意要清华北大的博士学历，还是北京的一套房子？	news_house
金旅海狮车怎么样？	news_car
欧洲庄园有什么好羡慕的？种些花草就可以攀比了	news_travel
上市公司炒股不忌讳“炒同行” 恒生电子买成科蓝软件第一大流通股东	stock
为什么山东大学会逐渐没落？	news_edu
在农村里，有一种树被称为“蛋树”，你见过蛋长在树上吗？	news_agriculture
汽车别直接去镀晶了，越镀越伤车漆！教你一新招，天天开干净新车	news_car
工信部：我国将加快制定服装大规模定制相关标准	news_tech
农村地里的野草需要除尽吗？长草会有什么害处？	news_agriculture
为什么要来这里看映山红？北京这处抗战圣地有着悲壮的经历	news_travel
县城地区小学教研片英语绘本课堂教学大赛在肥东六中顺利举行	news_edu
曹格的老婆在微博晒出了一组带儿女的合照 姐姐的大长腿令人羡慕	news_entertainment
「倡议书」关于广大市民推介临夏牡丹的倡议书	news_travel
侣行在伊拉克，叙利亚等的土豪行为，为后来的探险家造成巨大的伤害，您怎么看？	news_world
云横东岭松挺立；有什么好的下联呢？	news_culture
以色列警告称如果战机被击落将会轰炸俄军事基地，你怎么看？	news_military
考试，县级事业单位和公务员，应该选哪个？	news_edu
如果自身四维，武力，智力，社交能力，工作能力，按游戏数据各满分100来算，你是多少？	news_game
上联：月下品茶悟道，如何对下联？	news_culture
特朗普定下与金正恩会面时间地点 并邀文在寅访美	news_world
中国大西北飞出这一架战机了不得，空军实力陡增它立大功	news_military
宝马3系到底多靠谱？	news_car
与恶狗对峙，该怎么办？	news_military
苹果公司现金流近三千亿美元，会有收购阿里巴巴的可能性吗？	news_tech
课程回顾｜中国古代建筑技术	news_edu
为什么许多中国人喜好去泰国，而不去三亚？	news_travel
不知道的秘密：火车退役后都去了这些地方，实在是令人毛骨悚然	news_world
平邑：大麦滩的樱桃熟了	news_travel
本来不打算买Giulia，但是听说降到30.08万了	news_car
迪丽热巴的脚，杨幂的脚，刘亦菲的脚，在她面前都自惭形秽	news_entertainment
股市究竟应该如何去学？	news_finance
鼻烟壶是什么？做什么用的？	news_culture
永城的“紫薇大道”、“樱花大道”、“月季大道”您知道在哪里吗？	news_travel
女子花3500去纹眉效果不理想，店主：这两个字你要学一辈子	news_story
短文 回忆高三	news_edu
店铺开了快两个月了，换类目后每天一两个访客不知道怎么办？	news_tech
在青岛，夫妻俩每人一个月6000，是什么水平？	news_house
深夜村庄上的狗叫声不断，天亮后村民们发现村庄上的漂亮寡妇死了	news_story
成都雨泉新能汽车展销中心怎么样？媒体曝光后竟是这样……	news_car
“国六”即将实施，常用的“国三”“国四”会怎样处理呢？	news_finance
他单人单骑川藏80天：到达尼泊尔 回家后妈妈都认不出他了	news_travel
为什么许多中国人喜好去泰国，而不去三亚？	news_travel
世界上最大的格斗游戏比赛EVO，街霸5报名人数仅排第二	news_game
瑞士女人花2700万整了一张猫脸，猫看了表示不服	news_entertainment
如何看待第一詹黑皮尔斯，公开赞美詹姆斯？	news_sports
假如你的资产超过1000万，还需要出来工作或者上班吗？怎么安排比较好？	news_finance
蚂蚁金服上市了会怎样？	stock
王者荣耀：QGhappy在保级边缘挣扎，他们是真的茫然了	news_game
没有教不会的学生，只有不会教的老师，这说法正确吗？	news_edu
以色列警告称如果战机被击落将会轰炸俄军事基地，你怎么看？	news_military
食品、饮料与烟草业绩综述：从一季报看业绩超预期的公司	stock
信用卡如何养卡，如何提额快？	news_finance
《业余游玩》steam周销量排行榜	news_game
宝宝出生三天没睁眼，奶奶用手掰开，我发现后制止，差点酿成大祸	news_story
赵宁安作品欣赏	news_culture
发朋友圈被罚款三万，这件事触动到你了吗？	stock
浙江理工大学	news_edu
MSCI下周公布最新调整 中金公司料229只A股或被纳入	stock
济南导演《胆笑心惊》在济首映，致敬《倩女幽魂》	news_entertainment
UZI直播黄金分段，却被国服路人单杀！玩上单薇恩遭疯狂制裁！	news_game
恶搞漫画：金融危机对生活的影响	news_tech
印度军队打仗不戴头盔，而是戴头巾，是真的穷还是坚持信仰？	news_military
玉面狐狸死后，猪八戒为何要扒开衣服看一下，这里面大有讲究！	news_story
一斤两块五的青菜人都买的吃，为什么两块五的股票没人买呢？	news_finance
詹姆斯又压哨绝杀！联盟第一人毫无争议？	news_sports
夏季开车，这几种东西老司机都不会放在车上	news_car
为什么要有中考？	news_edu
特朗普助选重申“美国第一”，注定只能帮倒忙	news_world
金寨桂花公园“月亮”之夜美丽多彩！	news_travel
BAR步枪在美军步兵的火力配置中担任什么角色？	news_military
PS4独占大作《战神》结局深度解析	news_game
户口不在海南，在海南买房会限购吗？	news_house
蒜薹两毛钱，说“蒜你狠”的人该闭嘴了	news_agriculture
如果有陌生的亲戚来你家住，你烦吗？	news_story
作为央视体育体育频道，CCTV5一到周末就直播马拉松你怎么看？	news_sports
五月车厘子与你相约，美味大樱桃，采摘节开始啦！	news_agriculture
A股到底是继续下探，还是可能大反转？	stock
西游中唯一看穿佛教阴谋的妖怪，下凡三年，却没踏出洞府一步	news_story
三观不合，不如自己独过	news_story
一些股票明明业绩很好，上涨动力巨大，而主力为何却不断抛单压盘？	stock
在传销组织待了4年都不愿意出来的男人是什么心态？	news_story
董寿平｜海到无边天是岸，身登绝顶我为峰	news_culture
一对90后新婚夫妻的聊天记录，很现实很打脸！	news_story
联合国安理会改革废除一票否决权，会导致什么后果？	news_military
机油滤芯有一次性和可换纸滤芯的，为什么有设计区别？	news_car
夏天来了，去体验一把住房车呗！	news_car
五岁孩童独自生活，半个月自己煮饭，说出愿望让人落泪！	news_story
如果把范冰冰嫁给你，你敢娶吗？	news_entertainment
未来房价会跌到什么程度？	news_house
后来的我们！	news_story
“高抛低吸”有哪三条重要法则？	stock
以色列警告称如果战机被击落将会轰炸俄军事基地，你怎么看？	news_military
上联：江中鱼东游西藏，下联怎么对？	news_culture
别不信，女人生没生过孩子？这俩部位就能看出来！	news_story
为何有的人信用卡能做到快速提额？因为是这个原因	news_finance
为什么姑舅亲而姨表不亲？	news_story
小白龙最难为情的不是当坐骑，而是动物天天都能干的事他却不敢	news_story
你认为红白机历史上最难的三款游戏分别是什么？	news_game
是充电一夜对手机损害大还是电量没用完就充电损害大？	news_tech
伊朗风俗禁忌	news_world
5月6日09:23，津沧高速驶往沧州方向K47处的事故处理完毕；京哈高速驶往哈尔滨方向K81处的事故仍在处理中	news_car
How to say this这样的中式英语，你说错了几个？	news_edu
伊利股份计划5年翻一倍，应在多少价格范围内建仓？	stock
学习工程管理的学生，最适合考建造师和造价师，是不是？	news_edu
如果美国打伊朗，最快可以多久解决战斗？	news_world
美或借“协议”出手遏制伊朗	news_military
大宋朝才是书法艺术之花盛开的朝代	news_culture
上联：月下清贫花富贵，如何对下联？	news_culture
上联：院中红杏多浇水，下联怎么对？	news_culture
西红柿苗期冲施噻唑膦后发黄怎么回事？	news_agriculture
能进阿里巴巴集团做管理层领导的人，出来创业成功率能达百分之八十吗？	news_tech
永定区：着眼教育管理理念 提升教育创新能力	news_edu
《王者荣耀》的哪个英雄或者哪个技能最让你怀念呢？	news_game
机油滤芯有一次性和可换纸滤芯的，为什么有设计区别？	news_car
生活中的太子妃张天爱 网友：比做太子妃美艳	news_entertainment
炉石传说的卡牌有哪些有趣的外号？	news_game
为何张辽和高顺会被陈登所骗？	news_culture
中国十八世纪时，都有哪些著名的诗人？	news_culture
重庆所有高中排名，你觉得前五是哪几所？	news_edu
安全倒车9不要！	news_car
梅德韦杰夫对普京来说有多重要？	news_world
央行加息，股市应该如何投资？	stock
技术丨脱硫石膏在水泥生产使用中的几点措施	news_finance
未来房价会跌到什么程度？	news_house
中国堪比比萨斜塔的塔，门票不到一百！周末就去这里了	news_travel
罗永浩13点亲自确认，5月15日，他要发布2款革命性产品	news_tech
如何快速捕捉翻倍牛股，有没有什么技巧？	news_finance
雅阁，凯美瑞，天籁后期费用，大约都多少钱？	news_car
曹雪芹墓地石碑和玉器被村民发现，上交给国家，被奖励一面锦旗	news_culture
怎样把自媒体玩得有质量？	news_tech
英雄联盟里的十个经典笑话：为何放弃治疗，因为我要带闪现！	news_game
小学生托管老师如何提高检查作业的效率？	news_edu
以色列警告称如果战机被击落将会轰炸俄军事基地，你怎么看？	news_military
如果日本沉没，中国会接收日本难民吗？	news_world
宝爸姓“危”，说让孩子跟老婆姓，太奶奶取完名，邻居直夸：绝了	news_story
做好基层农村工作需要哪些基础知识？	news_agriculture
2018年美国中期选举，你认为特朗普会下台吗？	news_world
股票头天封涨停，第二天低开是怎么回事？	stock
学会好好说话，比什么都重要	news_story
乌鲁木齐红山小区怎么样 好户型房价走势	news_house
毕业季来临台生“登鹭”实习忙 厦门青创基地积极“搭台”	news_edu
王者荣耀：QG猫神：AG超玩会我们来陪你们了！	news_game
什么是内盘外盘？怎么看内盘外盘？	stock
四川游客张某带着六名女子在三亚沙滩烧烤被撒沙，这事你怎么看？	news_travel
英雄联盟投降规则改动，15分钟4人同意就行，你怎么看？	news_game
重回北川老县城 参观者更懂得珍惜当下	news_travel
开盘：沪指涨0.17% 填权妖股永和智控复牌涨停7连板	stock
老农去摘玉米，却在玉米秆上捡到很多现金，让人哭笑不得	news_agriculture
联合国安理会改革废除一票否决权，会导致什么后果？	news_military
中国核电概念股龙头有哪些？	stock
你的爱车装上这些小用品，既精美又显档次	news_car
两市晚间公告一览：一公司24.8亿投新能源汽车！股民：这够吗	news_finance
杭州的房价走势如何？	news_house
中国禁止进口洋垃圾，为什么英国很慌张？	news_world
为何法国巴士底狱暴动解放的人数竟然只有7个？	news_military
作为俄罗斯总统，普京上台以来有哪些失误？	news_world
从20%暴跌到0.8%仅用五年，三星手机为何会在中国遇雪崩式溃败？	news_tech
蒋欣出席活动，网友：这个发型很配这套礼服！	news_entertainment
关于中国的投资机会、中美贸易 巴菲特在股东大会上是这样说的	news_finance
神仙住在张家界 历史留在云朝山	news_culture
上联：黄山黄河黄皮肤黄土高原。怎么对下联？	news_culture
八年抗詹，何时是头！明年詹姆斯该对东部球队进行九年义务教育	news_sports
原来暑假可以这样玩，家门口的异国文化盛宴！	news_edu
你们觉得李秋平加盟山东队的可能性大吗？	news_sports
美国建国不过两百年，为什么会成为世界强国？	news_world
猪价持续低迷，影响猪价的因素有哪些，该如何扶持，才能减少养猪大户的亏损？	news_agriculture
如何判断开板次新股的走势？	stock
绝地求生里，能用赏心悦目来形容他们操作的主播，他当榜首	news_game
战斗机被导弹锁定追踪后，战斗机能否发射空空导弹摧毁追踪导弹？	news_military
特朗普为什么可以随意废除此前美国政府达成的各种协议？	news_world
民间故事：奇贼	news_story
深圳大鹏葵坝老路变身山水绿道	news_travel
北约16国在俄家门口举行军演，调动大批坦克战机，俄军将如何应对？	news_military
黄金原油下周走势分析	news_finance
猛龙主教练跟泰伦卢在这个系列赛的执教水平你怎么看？	news_sports
上联：一季花香游人醉，怎么对下联？	news_culture
如何在亏损中学习、进步、成功？	news_edu
新政策新趋势，解读企业的上市背后的门道	news_finance
原聚场——东原线下社群实体空间在东原印未来盛大启幕	news_house
一个人说他喜欢你，心里有你，可是从来没打过电话，只是微信聊天，他是真心的吗？	news_tech
产业资本态度转变 近9亿元资金净增持11只个股	stock
以色列警告称如果战机被击落将会轰炸俄军事基地，你怎么看？	news_military
云横东岭松挺立；有什么好的下联呢？	news_culture
小学生策划消防教育活动 提升对消防知识的了解	news_edu
未婚夫把祖传玉镯送我，无意发现镯子里两个小字我才知他阴谋	news_story
你碰到过的灵异事件，亲身经历的？	news_story
李连杰立遗嘱捐百亿，他拍戏代言没成龙多，为何比成龙还有钱？	news_entertainment
两岸不交流，大陆停止收购台南凤梨，果农欲哭无泪！	news_agriculture
到底是地球人的自我沦丧？还是外星文明的无耻入侵？	news_entertainment
上联：女子好，如何对下联？	news_culture
ANZ用五张图大胆预测：澳大利亚房价在今年会停止下跌并开始上涨	news_house
拜仁3比1逆转科隆，J罗现世界级做饼	news_sports
五菱宏光可以换发动机吗？噪音有点大，想换个大众的发动机，可行吗？	news_car
在海口生活，是先买车还是先买房？	news_house
华为若被美国禁了芯片和系统，影响大吗？	news_tech
老人路边救下一只鹅，半个月后鹅的报恩方式让老人泪湿眼眶	news_story
美团众包以后会消失吗？	news_tech
冷战期间，美国和苏联的坦克差异为什么那么大？	news_military
网易新游《第五人格》到底在玩什么？	news_game
爆发的微信小程序，电商的又一春？	news_tech
茂陵博物一日游	news_travel
车用润滑油变质标准是什么？怎么才能看出来润滑油变质了？	news_car
昔日女乒主帅施之皓，最近情况怎么样啊？	news_sports
2017新捷达1.5手动舒服型有哪些配置，买这车可以吗？	news_car
孔令辉说出当年分手实情，马苏成“万人睡”, 数十名男星被牵连	news_entertainment
皆大欢喜！国乒女队夺冠后接受采访 中肯评价日本女乒发挥	news_sports
笑笑宣布离婚：人命关天，各位兄弟也别说啥了	news_entertainment
信用卡如何把临时额度提升到永久额度？	news_finance
上半年证金公司“准举牌”了哪些上市券商？	stock
美国夏威夷火山爆发，同时伴随6.9级地震，一千度岩浆溢出	news_travel
小米所有的产品，有哪一种的核心技术是小米自己研发的？	news_tech
武威城区新增1条禁停路段！	news_car
一汽拼了！新车比奥迪漂亮十倍，造型个性设计前卫，仅卖8万！	news_car
电脑挂机软件是真的吗？	news_tech
德罗赞取尴尬数据三节“打卡” 他离“超级巨星”还差得有点远	news_sports
英雄联盟移速最快四大打野，剑圣仅排第三，第一没人追得上	news_game
美国后院起火，反对派内部冲突 俄媒：美在叙势力只是一盘散沙！	news_world
迷失在历史长河中的陕西茯茶文化还能归位吗？	news_culture
去非洲工作一年的人回来会有什么变化，年薪十多万值得吗？	news_tech
孩子英语不好，时态分不清，该怎么办？	news_edu
10万创业？	news_tech
以色列警告称如果战机被击落将会轰炸俄军事基地，你怎么看？	news_military
两套一年级数学第五六单元测验卷，比你想的难，阶段测试尤为重要	news_edu
趁年轻，去美丽的上川岛看一看	news_travel
微信滴滴不能用了怎么办？	news_tech
中金e配股票配资是实盘操作吗？	news_finance
哈佛商业评论：如何让自己与令自己厌烦的人感同身受	news_edu
烟台企业参加广交会入账1.23亿美元	news_finance
绝地求生：游戏中成就系统37项你完成了几个？	news_game
农村小孩能不能到城里读书？	news_agriculture
老婆非要装马桶，农村我只习惯蹲坑！最后还是老妈有办法	news_agriculture
李梦：出席活动，网友：这穿着打扮真是让人匪夷所思一饱眼福	news_entertainment
UZI直播 网友：震惊，韩服前十被国服黄金吊打	news_game
“老干妈”陶华碧恪守“坚决不上市”，你怎么看？	news_finance
雕工丑 VS 朴拙美，“另类”雕刻引争议	news_culture
基拉韦厄火山喷发 民防部门：火山喷发没有减弱迹象	news_world
在西安买房哪个位置性价比比较高？	news_house
为什么有的果树旺长却不结果？如何改造成高产树？	news_agriculture
五一小长假首日：通道侗寨游人如织	news_travel
收盘：美国宣布退出伊核协议 美股三大股指基本平收	stock
这些水果算是比较罕见的，一般地方很难遇到，吃过四种就不得了	news_agriculture
眼睛近视想考军校，是高考前或是高考后做激光手术比较好？	news_edu
刷爆朋友圈的综艺回归！《朗读者Ⅱ》有了新变化……	news_entertainment
女乒今天排兵布阵不合理，丁宁昨天刚打硬仗，今天应该打第一单打，你认为呢？	news_military
力帆股份再启定增 拟募资24亿元投新能源汽车产业链	news_finance
即将进入插秧期，如何做好水稻移栽前准备！少花钱不得病！	news_agriculture
粤媒：缺少外援的恒大还是不行	news_sports
夏播玉米，种肥同播，用什么化肥好呢？	news_agriculture
初见倾心，我在东部华侨城度过了美好的一天	news_travel
性别仿真机器人出现，我们还需要异性吗？	news_tech
以色列警告称如果战机被击落将会轰炸俄军事基地，你怎么看？	news_military
母猪产仔咬仔猪怎么办？	news_agriculture
黄鼠狼“黄大仙”有法力了之后会做什么事情呢	news_story
即日起 泸州“1965·茜草工业记忆”博物馆暂停对外开放	news_house
华晨宇除音乐之外还有哪些可塑性？	news_entertainment
刺激战场：空投里不只是有三级头，还有AWM等各种狙击枪	news_game
《战神》海外直播热度高 观看时长接近2000万小时	news_game
霸气！中国男队9-1击败德国 “王者之师”斩获世乒赛团体九连冠	news_sports
世界上最早的一副水彩画：丢勒《一大块草皮》	news_culture
机械式销售——内饰清洗这样讲能多卖	news_car
作为俄罗斯总统，普京上台以来有哪些失误？	news_world
自驾游不用住旅馆，新式“房车神器”横空出世！长这大还真头次见	news_car
奚梦瑶的腿怎么上热搜了？	news_entertainment
汽车，国三，国二的车型有什么保值的？	news_car
图看军事：美军C-130大力神，服役时间最长最优秀的运输机！	news_military
如何系统地学习股市？	news_finance
为什么一个国家不能无限印钞票来让自己有钱，购买更多国外资源以及进行本国建设？	news_world
月季花用鱼的内脏水作肥料，花开的旺吗？	news_agriculture
买宝骏730的车主后死悔！又一黑马SUV来袭，车长4米8，仅6万起！	news_car
在节目里懒得令何炅都崩溃的李诞，有个特别美貌的女朋友……	news_entertainment
为什么亮剑里边赵刚大学刚毕业到部队就是团政委？	news_military
因戴一个眼镜更改变气质的6大娱乐圈明星，你最喜欢哪一个	news_entertainment
国际油价创近三年半新高 国内油价今日料“四连涨”	stock
低调上架，小米新机4G+64G售1099，不用抢你会不会买？	news_tech
如何判断一只股票被高度控盘？有什么方法找主力控盘的股票？	stock
OPPO成功的秘诀是什么？有什么可以学习的吗？	news_edu
如果发生危机，要房子还是美元？	news_world
2018年成都房价还会涨吗？	news_house
如何评价《Fate/Zero》呢？这是我的看法，和你一样吗？	news_entertainment
那天，我亲自送老公去开房	news_car
美国动不动就拿撤军来威胁韩国、日本，日本、韩国为什么那么怕美国从他们那里撤军？	news_military
南阳籍将军有哪些？	news_military
游戏开发公司有哪些岗位？	news_game
108岁老人还下地干活，捉100只虾给家人做菜吃，还会喂给儿孙吃！	news_world
农民卖山里产的稀罕物山货，品种繁多都是好东西，你喜欢食用它吗	news_agriculture
爆爆，呆呆，阿木木历，汤米，清水，暗墨，星星知多少，大海，火焰，楚河…你们更爱谁？	news_game
教育那些事：高考后，优势专业与学校的选择（二）	news_edu
为什么经济已经十名开外的俄罗斯，还能够稳居世界军事强国，并和美国针锋相对？	news_military
有哪些好用的护发产品？	news_tech
我惩罚老公给我洗脚，婆婆突然开门，老公的话让我热泪盈眶	news_story
Brian Kelly：比特币在短期内将继续激增的三个原因	news_finance
绝杀猛龙之夜！詹姆斯5次重摔在地，再心酸也值得了！	news_sports
红薯叶喂猪的诀窍	news_agriculture
恒大到底输在哪里？！0:3之后卡帅一番话给出输球真因！	news_sports
高送转含权股的操作方法有哪些？	stock
沪上中小学今年第一波毕业照出炉啦，你也晒晒自己的吧！	news_edu
巴菲特：美国人生活会越来越好 比洛克菲勒都要过得好	news_finance
首只独角兽周二上市！8个涨停赚4万，近期新股收益大幅提升	stock
2000左右买什么手机？	news_game
给你一亿人民币或者一家上市公司，二选一。你会选哪个？	stock
玩家求官方加强猴子，别改李白，策划一一答复	news_game
新一代唐只是个开始，全新秦这颜值实力，能让国产新能源市场翻天	news_car
王者荣耀：当队友选这三个奇葩英雄打野的时候，我就知道此局必输	news_game
雨花微旅行 圭塘河岸	news_travel
如果世乒赛第四局中，刘诗雯不是碰到也同样输一局的平野美宇，结局会怎样？	news_sports
宋朝的家国情怀	news_entertainment
英国乡村风光最好的只有Cotswolds吗？	news_agriculture
费启鸣抖音走红，邀请上快本后颜值遭质疑？原因是有幕后推手	news_entertainment
空姐与彭于晏亲密合照，喊话他今晚是我的宣示主权	news_entertainment
越南拥有110余万军队，为何越南军队最擅长布置竹签阵？	news_military
康熙祭拜孔子没有跪下，大臣挡住墓碑上一个字，康熙立即下跪叩拜	news_culture
摆地摊小本生意卖什么最赚钱，那种销售模式适合你	news_finance
直击：美国历史上第一位平民黑人总统的成长经历	news_world
朱元璋为何要将沈万三满门抄斩？	news_culture
昌黎县房价怎么样？	news_house
标题党真心严重，把腾讯坑坏了！	news_tech
女排国家联赛已成新人试金石，她若能把握住上位良机必成大器！	news_sports
女子科目二满分网上却显示零分 工作人员：只能再考	news_edu
“茶叶女”是如何行骗的？利用了人们什么心理？	news_culture
以色列警告称如果战机被击落将会轰炸俄军事基地，你怎么看？	news_military
气愤！美国为阻止中国技术增长，竟然想向100万中国留学生下手	news_world
历代名家书法精品——赵孟頫《灵隐大川济禅师塔铭》	news_culture
连跌12个月，厦门各区二手房成交价大曝光	news_house
朱婷在女排欧冠半决赛中受伤，这会对瓦基弗产生怎样的影响，还能够夺冠吗？	news_sports
叙利亚政府军从一处叛军据点缴获的武器里面有俄制的装备，你怎么看？	news_military
酒糟新用途？酒糟分离机助力！	news_agriculture
原料上涨叠加需求转旺 纸价开启新一轮上涨	news_finance
在一个跟自己实力完全不符的学校学习是什么感受？	news_edu
卡扎菲和他的美女保镖们，他们之间真像外界传说的那样不堪吗？	news_world
《王者荣耀》有哪些法师不依赖铭文？	news_game
很多农民都不愿生二胎，却不知独生子女即将面对这三大难题！	news_agriculture
被誉为日本劳斯莱斯 丰田顶级豪车 它才是政商大佬身份的象征	news_car
你赞成婚前同居吗？	news_story
第一悬案！丈夫杀害孕妻后焚尸，留下诡异现场，法医说的话太吓人	news_story
山西：一季度商品房待售面积比上年末减少148万平方米	news_house
自驾游西藏无人区加油问题怎么解决？	news_travel
5月31号前，企业需完成汇算清缴工作，会计注意这5个细节问题	news_finance
我们公司是高科技中小企业，在电力及新能源领域，年销售额2000万，净利润250万左右，能上新三板吗？	stock
买了高层西边户会不会夏天很热，会受到什么影响？	news_house
市北区（青岛）80个小区最新二手房价，你知道的小区涨了？跌了？	news_house
保留院落乡土特色避免“千村一貌”	news_agriculture
你为什么还在坚持玩《炉石传说》这个游戏？	news_game
“天地板”操纵案手法曝光 老牌私募被罚1亿！	stock
秀丽多姿的山川溪水——浦江茜溪，金华人夏天最爱的旅游风景区	news_travel
「头条」2018-金色里程，最新详情解析！马鞍山当涂住宅！	news_house
妈，你玩什么黄昏恋啊！真是越老越不害臊！	news_story
绝地求生12轮更新新增内容讲解：新配件与倍镜的抉择	news_game
景甜厉害了！恋爱之后体重过百了，网友：张继科真会疼人	news_entertainment
如何有效学习？	news_edu
争冠关键战，老妇人能否主场擒敌	news_sports
李谨詺：周一该如何布局，5.7黄金不破1318短期震荡下行为主	news_finance
“擒龙术”核心——抓龙头让你不错过题材或者板块龙头的任何机会	news_finance
神盾的2000吨小舰，火力居然比中国054A还猛，我害怕	news_military
丈夫遇车祸去世，妈妈骗女儿爸爸出差了，女儿反应感动众人	news_story
真人秀综艺新突破，《青春同学会》见证表演界不一样的同学情	news_entertainment
如何对付柑橘红蜘蛛？	news_agriculture
孩子真的在幼儿园被孤立？家长先反思，再听老师怎么说	news_edu
股票在涨停后，半小时又下去了，再过一会又涨停1个小时，随后又下去了，这说明什么？	stock
山西运城的房价近期会有大的上涨吗？	news_house
纠结七天的日本行程，关西进出该不该去东京？	news_world
股票成交量很低，但是价格降的快说明什么？	stock
女子出一上联：一杯清茶，解解解元之渴！解缙至死都没对出下联	news_culture
中国历史文化名镇、广西四大古镇之一大圩古镇走访记	news_travel
探秘最后的香格里拉之魂，纵使错过全世界，也不愿意错过你	news_travel
“中国标准”名扬苏丹维和任务区	news_military
为什么越来越多的安顺年轻人到贵阳买房？	news_house
以色列警告称如果战机被击落将会轰炸俄军事基地，你怎么看？	news_military
FF 91抵达北京，为国产做准备，贾跃亭要归来了？	news_tech
村里来了一男一女，见到那个傻老太就下跪，才知傻老太不一般	news_story
青龙戏白虎，江涛乐夜风。如何接句？	news_culture
《彼得兔2》定档 萌贱小兔2020年2月7日将归来	news_entertainment
央行“定向降准”会对股市构成利好吗？	stock
中国近20年的房地产高速发展，对中国科技的影响有多大？	news_house
骗子不够多，傻子永远都够用	news_finance
如何判断次新股是否已经见底？	stock
中国有没有能力自主研发高端芯片？	news_tech
专业探险队深入洞穴探洞，发现里面的宝贝可真不少！	news_travel
昆凌和别的男人穿情侣装，周杰伦吃醋	news_entertainment
世乒赛决赛，刘诗雯2:3不敌伊藤美诚，对此你怎么看？	news_sports
如何看待现在的UZI的水平？	news_game
大理的喜洲古镇有什么好吃好玩的？	news_travel
乌衣巷口夕阳斜，下一句是什么？	news_travel
为何刘嘉玲出现危机？昔日好友关之琳却这样回答！	news_entertainment
王者荣耀：S11赛季强势英雄榜，张良咸鱼翻身，成中路上分黑马！	news_game
吴卓林：你父母固然有责任，但最大的责任还是在于你自己！	news_entertainment
难得一见的素描作品，书画爱好者的福音！	news_culture
裕安区平桥乡助力国际马拉松赛	news_sports
冶师附小召开“家校携手育英才”家庭教育专家报告会	news_edu
亚洲杯小组赛中国队赛程出炉：首战吉尔吉斯斯坦	news_sports
上联：九日为旭，人人从，下联是什么？	news_culture
如果现在一架最先进的战斗机穿越至秦朝坠毁，你觉得秦朝人能逆向出什么黑科技？	news_military
好莱坞7位惊世美男也禁不住岁月的琢磨	news_entertainment
我妹的同事，她老公村子的灵异故事，老一辈的往事！	news_story
农村新生代模特	news_agriculture
六万至八万元之间，买什么车比较好？	news_car
北师大版一年级下学期数学期中试卷，家长可按答案评分标准改卷！	news_edu
在家养龙虾，为什么几个月以后龙虾不见了？	news_agriculture
上联：江中鱼东游西藏，下联怎么对？	news_culture
小升初17年南京真题，据说题目类型没有多大变化，尽早看看！	news_edu
一发155榴弹击中M1A1坦克的正面装甲能否将其摧毁？	news_military
美国为什么怕俄罗斯？	news_military
嘉陵又一商业中心即将崛起，坐拥都尉路城市中轴核心区！	news_house
绩效比教师高2000多，谁拿走了老师绩效？	news_edu
免费畅玩Dota2所有饰品！DOTA2 MOD软件安利	news_game
女子半夜上厕所，发现坑里有眼睛盯着她，警察赶来忍不住笑了	news_story
富县：建成千亩田园综合体 打造黄土高原“稻梦空间”	news_agriculture
聪明女人都不在家养花了，改种这几种果苗，年年水果吃不完	news_agriculture
司法拍卖 东方太阳城 北京法拍房2万/平米在售 可贷款 可垫资	news_house
大宗交易是什么，为何进行大宗交易而不直接在二级市场上购买股票？	stock
独家｜华林证券IPO过会3个月，核准批文却迟迟未来	stock
什么样的地方才适合诱蜂？有经验的蜂农选择诱蜂位置有什么特点？	news_agriculture
哈马斯不承认以色列，那么哈马斯还能坚持多久？	news_world
东归英雄传用了多少马？	news_game
运用年线决定操作方向	stock
9种好吃高营养的“特色”果树，趁早栽进地里，以后水果免费吃	news_agriculture
微信支付是否已远远超过支付宝？	news_tech
准备卖大米，面粉，油，应该在哪里进货？	news_finance
家长速看！外地户口的小朋友在威海上小学都需要什么？	news_edu
为什么当代青年评选“十大读不下去的书”，《红楼梦》排名榜首？	news_culture
冯天睿：5.6千三大关何以告破 黄金原油下周一操作建议	news_finance
河南叶县扶贫广播“打通扶贫政策落地最后一公里”	news_agriculture
大荔县朝邑镇：乘“大马”东风 展名镇风采	news_sports
厉害了！武汉一高校学子在2018华中区学生跆拳道比赛中夺得14金！	news_sports
qq飞车手游中为什么针尖那么不受人待见？	news_game
德系血统，比朗逸高级，当年售价近20万，今跌至9万十分厚道	news_car
《后来的我们》都成长了 那么你懂得珍惜了么	news_entertainment
继乔任梁后这位明星也不堪重负精神崩溃深夜发文求粉丝放过自己	news_entertainment
产业地产开始转热	news_house
松涛听雨莺婉转，下联？	news_culture
赛车手的倾心之作！一不小心用了晓乐同款	news_car
老外挑战100小时不睡觉，看完后我默默的盖上了被子	news_world
如果马其顿军队遭遇大秦军队，谁会赢得胜利？	news_military
外出旅游时，吃东西被坑的最惨的一次是怎么样的？	news_travel
荣威RX8试驾，一顿操作猛如虎！	news_car
倪萍和陈红，你喜欢谁？	news_entertainment
一夜之间，马云放大招，芝麻分700，网商贷可借百万	news_tech
立夏狂风暴雨，西安市民都不淡定了，你怎么看？	news_agriculture
陈冰出席发布会，网友：就服你这二郎腿，实在是太有个性	news_entertainment
玩《英雄联盟》时，总误触ctrl键，怎么解决？	news_game
练车时，你被教练骂过吗？怎么骂的？	news_car
3个纬度：财务数据优质+高增长+低估值 选出这10家高质量公司！	stock
细看不似人间有	news_travel
联赛8轮不败+斩落领头羊 国安搅乱中超争冠格局	news_sports
「诗歌」梦里	news_culture
宝鸡石鼓园美景	news_travel
下个周末崂山北宅樱桃将迎来集中上市期 结伴去体验采摘乐趣吧	news_agriculture
我们快被群里的小程序游戏逼疯了！分享几个解决办法……	news_game
成都摇号选房·天立世纪华府——彭州清水均价5476，不是投资处	news_house
玉米在播种前，需要二次包衣吗，为什么呢？	news_tech
2018年美国中期选举，你认为特朗普会下台吗？	news_world
世界第一伟人是谁？	news_travel
徐州与一线城市的差距主要在什么地方？	news_house
昔日中超金靴半场独造6球虐爆辽足 华夏送走他后悔吗？	news_sports
同学结婚我随礼三千，第二天看到同学群里的消息，我默默退了群	news_story
贴心小老公给爱车换上这几款车品，跑长途开夜车，样样有大用处	news_car
你第一次被魔兽世界震撼到是什么时候？	news_game
第一次去男友家，拎了好多东西，他妈留我吃饭，我当场跟他分手	news_story
补精神之钙 添脱贫动力（话说新农村）	news_agriculture
民间奇闻-天定状元，让一犁	news_story
道德经第十一章讲解译文繁体小篆版	news_culture
一年级下册数学期中试卷，有点难，尖子生也考不了满分	news_edu
考驾照一次性通过，并不一定是技术好！你忽略了最关键的因素！	news_edu
韩国本国公民去济洲岛需要持什么证件？	news_world
上联：杯中有酒赏明月，怎么对下联？	news_culture
德帅谈没球队面试布兹德里克：出于自私的原因，他在这让我开心	news_sports
几款适合年轻人的车，八万左右，月供1千就能行	news_car
VR 3.5渲染器大图渲染设置，再也不担心不会设置了	news_game
买房银行审批通过但就是不放款，怎么办？	news_house
以色列警告称如果战机被击落将会轰炸俄军事基地，你怎么看？	news_military
环保中小企业享受减税利好，环保装备制造企业同步起飞	news_finance
2018.5.6币值排名前20 总市值突破30000亿	news_tech
探界者1.5次低配和速派330舒适怎么选？	news_car
再现绝杀！今天的老詹怎么吹	news_sports
西安房子2018年能入手吗，会不会成接盘侠？	news_house
农村婆婆用草给儿媳包饺子，没想到儿媳却吃上瘾了	news_story
股东大会上，巴菲特还提到了减税、通货膨胀、报业转型	news_finance
都说王者峡谷里老公打不过老婆，那为什么王昭君就很难打过李白呢？	news_game
“移动医疗第一股”平安好医生港交所挂牌上市，融资11亿美元	news_finance
如何判断热点题材板块的持续性？	news_finance
报警灯亮了刹车片就要更换吗？	news_car
如果美国各个州独立了，世界格局会发生什么变化？	news_world
同父同母不同命，哥哥退出演艺圈生活窘迫弟弟曾红的发紫	news_entertainment
俄罗斯90多个城市爆发反普京游行示威，警方逮捕上千人	news_world
海尔总裁周云杰：中国智慧物流品牌日为世界贡献中国智慧	news_tech
龙虾田水深多少最好？	news_agriculture
美国建国不过两百年，为什么会成为世界强国？	news_world
故事：农村傻小子不信老道会法术，老道抓起一把黄土说“请闭眼”	news_story
农村的集市该不该取消呢？	news_agriculture
山西考生超一本130分，能上什么大学？	news_edu
小米上市后市值若超过百度，会带来哪些影响？	news_tech
我国大量的进口的国外大豆，用到哪里去了呢？看完才明白！	news_agriculture
登高投身云海间，早晨抚摸阳光炊烟，荡漾湖上与湖怪嬉戏	news_travel
你怎么看待以色列总理出席俄罗斯5月9日的阅兵并会晤普京？	news_military
高校CP“秀恩爱”是怎样的体验，你想知道吗？	news_edu
出栏一头猪亏损300元，究竟谁能笑到最后！	news_finance
6月30号后取消第三方支付直接扣账，支付宝还能直接用于支付吗？	news_finance
DNF：玩家打团时睡着了，为了守护阿拉德大陆殚精竭虑	news_game
招教和特岗教师有什么不同？	news_edu
散户大幅度减少是好事还是坏事？	stock
路虎揽胜运动——展现雄浑的动感形象	news_car
种地不用化肥会怎样？	news_agriculture
女邻居的秘密（全）	news_story
一季度“国家队”持股新动向：证金增持15家券商 基金资产首现大幅缩水	stock
18款福特猛禽F150 3.5T白金版墨版皮卡大咖	news_car
龙岩碧桂园小区环境，物业服务怎样？	news_house
白敬亭奶凶登上热搜，可爱又帅气的白侦探，调皮起来也是又奶又凶	news_entertainment
现在很多人做淘宝优惠券，如何盈利的？	news_tech
全程2000公里，历时5年的京九铁路为何才耗资507亿？	news_military
分红后要除权，股价相应下降，股东也没多赚到钱，意义是什么？	stock
转型中的长安汽车，推高端品牌，7年内能达到600万的销售规模吗？	news_car
寻找地产界“最强大脑”——中国房企2018年度CFO评选启幕	news_finance
为什么父辈买养老保险，而子女不买就不可以领养老金？	news_agriculture
且行且珍惜：这些明星原谅了出轨的另一半，换个人估计做不到	news_entertainment
考上中国矿业大学北京研究生是什么感觉？	news_edu
经常开车，车漆越开划痕越多！教你一招，1分钟消除划痕还不留印	news_car
催人泪下的六张图片，你能忍到第几个？	news_story
今年西安第18批备案价出炉 754套房源入市	news_house
宝马车被贴满女性用品 监控拍下深夜恶作剧女子 究竟有何深仇大恨	news_car
10kw风冷柴油发电机/大泽动力双缸柴油发电机	news_car
离开新疆的李秋平，下赛季会到哪个球队执教？	news_sports
二线城市房价借风助燃，你还在犹豫什么？	news_house
易县最美的五月，蓝色油菜花开好了	news_travel
留住乡愁！湛江最美古村落要消失了，抓紧机会看一回吧	news_culture
射雕中的十大高手，郭靖垫底，周伯通第五，黄裳无人能敌	news_story
什么叫做深度学习框架，其作用是什么？	news_tech
现在手机网络发展是不是过快了？	news_tech
以色列警告称如果战机被击落将会轰炸俄军事基地，你怎么看？	news_military
火箭与爵士的第3战 火箭的轮转发生了变化 这变化将改变一人命运	news_sports
《空洞骑士》值得入手吗？	news_game
三清山，世界上已知花岗岩地貌中分布最密集、形态最多样的峰林	news_travel
NBA最弱球队和CBA最强球队打比赛，哪个能赢？	news_sports
日本最环保的小镇：15年来零垃圾，一群老人靠捡树叶年入千万	news_travel
区块链极简史2：比特币的转账机制 CCR炒币机器人	news_tech
我带婆婆去医院看病，女儿突然叫了声“爸爸”，婆婆给我一巴掌	news_story
怎么看因为性侵丑闻，二战后诺贝尔文学奖首次停摆？	news_world
巴基斯坦和伊朗会一起入侵以色列吗？	news_world
PPP模式聚焦旅游重点领域 社会资本需有更高要求	news_finance
8个月孕妇仍坚持工作，靠搬砖夫妻月入9000	news_story
美国爸爸在网上分享了妻子的剖腹产账单，原来在美国生孩子这么贵	news_world
巴基斯坦两处煤矿发生矿难致18人死亡	news_world
一个故事看懂金融危机时钱都去哪里了？	news_finance
王者荣耀：小姐姐一分钟收到八个曙光守护者！这样要皮肤真的好吗	news_game
为什么有大单进入股价还会下跌？	stock
宝骏510跑工地怎么样？	news_car
盘点明星大佬们身旁都有些什么样的保镖	news_entertainment
春风欲走花言谢，下联如何对？	news_culture
为何美国从未发生过军人独裁统治？	news_military
印度能够复制中国奇迹，超过日本成为世界第三大经济体吗？	news_world
传统弹弓早就过时了！当下特流行这强悍狠货，功能霸气更给力	news_car
今日开盘：小幅低开 沪指跌幅 0.04%	stock
2018艺术厦门博览会5月25日开幕 将展示上万件艺术珍品	news_culture
MSI微星游戏本6G独显和7代i7，开挂般的神奇体验！	news_game
国家德比来袭！巴萨力争胜利送别大师，皇马却摆出全替补阵容？	news_sports
五月冰城变花海，看丁香花丛中的哈尔滨	news_travel
无奋斗不青春｜大火箭总装团队：我为祖国铸利箭	news_military
历史上的今天：5月6日	news_world
旅行是一种爱好，了解新鲜的事物	news_travel
今日直播龙星战及女子围甲 + 星阵让先9连胜 + 暗渡陈仓	news_sports
美国是怎样进行爱国主义教育的？	news_edu
如何巧妙地给别人留下良好印象？	news_travel
美航母刚在叙利亚空袭，俄军就果断亮剑：美军这下危险了	news_military
在北京国际车展领克展台……仿佛去了一趟游乐场？	news_car
谢娜创两项吉尼斯记录，中国第一人，网友回复最扎心	news_entertainment
跟天赌与地斗，如今行情摸不透，老菜农一句话总结56年种菜辛酸	news_agriculture
实在人做实在事	news_agriculture
如果你在北京有一套房子价值1000万左右，你会不会卖掉房子拿着钱回老家？	news_house
你见过最努力的人现在都变成什么样子了？	news_edu
李晖：切实帮助搬迁贫困户融入新环境 致富奔小康	news_agriculture
农村盖房子的物料，虽然很廉价，它的药用价值，你们都不知道	news_agriculture
高考“白卷”考生10年后考取大专 后悔浪费高考机会	news_edu
2018年农村房产证已陆续发放，但这些人没有机会领取！	news_agriculture
诗词欣赏：闺怨	news_culture
世界上最“神”速算法，秒杀计算器！只发一次，替孩子收藏！	news_edu
建筑工程中同一项目，母公司投标，子公司能否投标？	news_finance
京城最值得你来场文化之旅的博物馆	news_culture
认真搞笑的男人最帅！大张伟不张嘴就是美男子之最！蜜汁好看~	news_entertainment
非洲为什么没有熊？	news_world
告诉你为什么城里买不到真正的农村土鸡蛋	news_agriculture
DNF：为什么你达到了打团的要求却没人要？只因为你差了这一件装备	news_game
如何看待曹德旺说的，“一百对夫妻中，没有一对是幸福的”这句话？	news_culture
美国女星凯莉·詹娜黑色纱裙参加好莱坞派对，造型时尚	news_entertainment
摘樱桃咯！青岛樱桃园大全	news_agriculture
如果本赛季詹姆斯率领骑士夺冠，詹姆斯将有怎样的历史地位？	news_sports
歼20可以不费吹灰之力！让美国深深的体会到了被打脸的滋味？	news_military
跑马拉松你是如何准备的，要准备些什么？	news_sports
「王源壁纸」就喜欢看你那纯真的笑容	news_entertainment
Honda为中国市场打造专属车型亮相上海，众多焦点车型展出！	news_car
为了应对德军的狼群战术，盟军都采用了哪些手段？	news_military
招行呼和浩特分行感动服务添新举措	news_finance
想在西安买一套公寓，总价40万左右的有吗？	news_house
19年亚洲杯国足所在的C组算是上上签吗？	news_sports
完美7座车和垃圾7座车，只差这么几样小东西	news_car
杰森-特里：塔特姆打出了超过他年龄的极佳表现	news_sports
韦德的一句bad boy！网友们炸了：个个都是段子手！	news_sports
尤纳斯下赛季会留在广东吗？这两人或许比他更合适，朱总会选谁？	news_sports
两个在各自的游戏上称得上一哥的主播，为什么到最后下场却不一样	news_game
三条小故事（深度好文）	news_story
从出题套路中掌握考高分技巧，揭秘中考数学出题套路（三）	news_edu
女儿美到路人自动献花，爸爸辞职当“保镖”	news_world
dnf旭旭宝宝红眼新高度百万战力，五件娜迦王海伯伦加持，和国服其他红眼差距有多大？	news_game
上联：拜托流云捎往事，如何对下联？	news_culture
全新外观/动力提升！新款Macan谍照曝光	news_car
小记——我记忆中最温暖的时光	news_agriculture
预算3000元，什么牌子的平板电视比较好？	news_tech
大学学艺术是在浪费钱？将来挣的钱要比现在花的多	news_edu
昆明这个地方的蓝花楹美得不像样，一生中一定要这样欣赏一次	news_travel
房子漏水，物业不管，该怎么办？	news_house
存100万赚利息，就可以不上班了吗？想得太美	news_finance
电动汽车是否真的能成为下一个汽车研究热点？	news_car
腾讯股价再创新高市值破3万亿，还有哪些“神股”只涨不跌？	stock
妙龄少女过玻璃栈道，路人眼睛都看直了！	news_travel
英雄联盟：UZI直播时间确定，粉丝疯狂舔屏！UZI女朋友都害羞了	news_game
青岛有哪些好玩的地方？	news_travel
广安十六景 景景皆有情	news_travel
城里买房还不如回村建别墅，过幸福的田园生活	news_agriculture
中国辽宁航母战斗群的战斗力如何？	news_military
来说说微信破裂了多少家庭？	news_story
夏日拍花儿好去处：滑县森林公园里的“月季园”芳香四溢味正浓	news_travel
北京现代将推4款电动车 插电索纳塔7月上市	news_car
为什么青岛的房价还这么贵？	news_house
美国参议员麦凯恩说他的葬礼上不请特朗普，大家怎么看？	news_world
“萝卜章”事件拖累净利巨降63% 国海证券换帅传闻市场关注	stock
高位十字星是好是坏？	stock
又一款国产中大型7座SUV将于后天正式上市，你喜欢吗？	news_car
A股“入摩”临近外资加快布局 6股将爆发在即	stock
特朗普担任总统后，美国是更强还是更弱了？	news_world
地理考试加油！	news_edu
高三学生如何合理安排暑假？	news_edu
CFPL赛程，久离CF的你还会关注吗？	news_game
为什么现在还有人在等着房子降价再买？	news_house
白马蓝筹股的价格突然下跌，原因有哪些？	news_finance
如果证实反政府武装使用化学武器，美英法会被追责吗？	news_world
四国青年女篮亚特拉斯赛在秀举行	news_sports
语文中考复习：三看	news_edu
深度好文：中国制造业需要摆脱三个陷阱	news_finance
迪丽热巴模仿刘亦菲穿起帅气的西装，你觉得谁会更好看呢？	news_entertainment
信用卡代还业兴起，众多平台被爆存违规套现、乱收费等问题	news_finance
朱婷受伤下场调整，瓦基弗银行差点被逆转，朱婷决胜局力挽狂澜	news_sports
如果一没有资金二没有技术，但是有创业的激情，应该如何创业？	news_finance
多少只猛犬才能打的过东北虎，甚至能杀死老虎？	news_world
如果没有时间冷却，王者荣耀哪个英雄开大最厉害？	news_game
无兄弟不篮球，胜利并不是所有，身边有一个好兄弟陪你分担，足矣	news_sports
印度一男子不顾劝阻要和熊自拍，被咬死，大家怎么看？	news_world
世界高超音速武器哪家强？中俄领先 美国已落伍	news_military
叙利亚前线吃紧，北约舰队进入黑海，他们的目的是什么，你如何看待此时北约的军事行动？	news_military
屠户杀狗，狗下跪求放过，老汉好心救下，狗竟用如此方式还他一命	news_story
“北大校长错别字”背后折射的现象令人深思	news_edu
俄罗斯为什么斗不过美国？	news_world
450亿！又一500强民企跨了 释放哪些信号	news_finance
DNF：六人raid2保4!第二脊椎了解一下！	news_game
准备职业炒股该从哪里入手？	news_finance
四川巴中有哪些好的装修队？	news_house
马云又出惊人言论，8年后房子最不值钱，他的话可信吗？	news_house
海南法国维希小镇：23万一套起 低密度果岭度假社区 享受静懿生活	news_travel
贵州毕节的这几处溶洞，夏天探险的好去处	news_travel
无抵押贷款都有哪些途径？	news_finance
《西游记》最后为什么两个和尚要向唐僧他们收贿赂才肯把真经给他们？	news_culture
我月薪二万，比你高好几倍，我拿自己钱给我弟还房贷咋了？	news_story
休斯顿火箭队哈登和雷霆队威少，还有金州勇士队杜兰特，谁的实力更强？	news_sports
蚂蚁花呗是否属于小额贷款，会影响个人征信吗？	news_tech
立夏到，如何顺应气候养好心？	news_travel
世界犬种介绍之30：犬中帝王——阿富汗猎犬	news_world
最近股票亏了4万多，本金只有10万，还有必要坚持吗？	news_finance
今年以来多地房贷利率上涨	news_house
额度这么低，信用卡怎么提到10万呢	news_finance
3个月贡献392亿，中国游客去日本却不为旅游观光，到底为的什么？	news_travel
为什么在淘宝货源里有的可以分销有的不可以？	news_tech
有没有文凭很低，但知识水平很高的人？	news_edu
来广元考察交流的巴中市妇联，看看她们都去了哪？	news_agriculture
来自未来的亮相！领先设计引领时尚新潮流	news_car
农村俗语“出门看天色,进门看脸色”是什么意思？	news_agriculture
千人相亲大会，单身的有福利来了！	news_travel
林允骂哭同剧演员？金晨自爆恋情？大S吓跑投资人？	news_entertainment
手机行业总体疲软的态势下，苹果为什么实现了逆势增长？	news_tech
你开过最快的车速是多少？	news_car
Uzi获得冠军后直播首秀730万人气，首局游戏老鼠拿下五杀	news_game
萨达姆究竟多有钱？看到这些照片后，网友都说难以置信	news_world
孙宏斌接盘乐视一年浮亏近30亿，却曲线揽入大量土地，孙宏斌打得是什么算盘？	stock
鲁哈尼：如果美国退出核协议，将会感到“前所未有”的后悔！	news_world
泰山游记——一个人的自驾之旅	news_travel
多点开花，国际米兰客场大胜乌迪内斯	news_sports
长安新车撞脸大众，比宝骏510大一圈只要6万起，又将是爆款？	news_car
明明是大妈年龄，却非得演少女，看到最后一位只想说：还我男神！	news_entertainment
中国第一“鬼村”，在河南，就问你敢不敢去？	news_story
主播一声“干妈”妇人赏30万再送名表，女儿气的断绝关系	news_world
DNF攒蓝矿+红豆换荒古是一种什么样的体验？	news_game
房价涨那么高，为什么还有人抢着买？	news_house
上联：江中鱼东游西藏，下联怎么对？	news_culture
中国楼市不断上涨，李嘉诚为什么加速撤离中国楼市？	news_house
深圳布吉哪些地方有旧改拆迁的项目？	news_house
藏南面积有多长多宽？	news_travel
别总想着换发动机！这几个关键部位不检查，难怪车子越开越耗油	news_car
夏天来了，钥匙别往裤兜塞，试试这6款多功能钥匙包，实用有格调	news_car
学高为师推荐：小学一年级下册语文句子题（附答案）	news_edu
2.4精英版欧蓝德换挡拨片怎么用？	news_car
英雄联盟最秀的AD中单，男刀第三，第一秀到你怀疑人生	news_game
陈柯枫：5.6黄金将继续反弹，下周操作策略	news_finance
如果你有50万，是愿意在农村盖别墅，还是去小县城买一套小房子？	news_agriculture
因为感情不和妻子离开了他，为了照顾孩子他必须背着孩子高空作业	news_story
对敲是什么意思？主力盘面对敲骗术怎么看？	stock
大胃王密子君直播吃重庆老火锅，服务员在旁边不停加菜，真心疼	news_agriculture
行长很着急：浦发银行成唯一利润负增长银行，造假竟造出零不良率	news_finance
一个细节证明，B21轰炸机要服役了，全球没一个系统可以拦截	news_military
苹果，ipad玩绝地求生怎么录制精彩视频？	news_tech
游资王简介：欢乐海岸VS作手新一	stock
何诚总代表与图兰大学进行联合办学项目会谈	news_edu
房价会不会再次上涨？	news_house
中国网红竟红到美国？不多说了，连小编都心动了	news_entertainment
6.4入手的大众高尔夫，全靠老爷子一人入手，千万不能得罪老人家	news_car
这才是老詹一见猛龙就往死里打的真相，真是让人拔凉拔凉的！	news_sports
丢一场赢一场，今天刘诗雯在世乒赛女团决赛的表现值不值得表扬？	news_sports
我用他卖身换回来的钱治病	news_story
跟万达学管理，怎样保质保量甚至提前完成计划目标？	news_tech
奶奶让5岁孙女学做家务，孙子打游戏，2年后孩子的变化让奶奶后悔	news_story
詹姆斯G3绝杀猛龙，最后时刻追上骑士，猛龙心理有阴影吗？	news_sports
美国独立后，林肯曾想把黑人送回非洲，因一个原因不得不放弃	news_world
DNF：魂牛记录再次刷新，剑魂携驱魔弹药奶爸47层通关成功！	news_game
国内小众旅游景点，个人感觉还可以，经济实惠的穷游	news_travel
微积分的本质是什么？	news_edu
刘涛出席活动，现场被王自健揽腰抱起不撒手	news_entertainment
想买个2万元以下的二手车，不要面包车，哪个牌子比较好？	news_car
如果房地产未来不是最好投资方向，会转什么行业呢？	stock
世界之大无奇不有！Kansas 男子试图与爱车啪啪啪被捕	news_world
一天烧近290万元，现今，它到底有多重要	news_entertainment
每袋135元的肥料最多值60多元！忽悠团联合村干部合伙坑害农民！	news_agriculture
新疆最美的7个地方，你都知道是哪里吗	news_travel
为什么说去泰国旅游，千万不能去捡海边的贝壳？	news_world
小学生“奇葩”试题，家长被“虐哭”，网友：能做出一道就是人才	news_edu
什么样的炭燃烧时间最长？	news_travel
九鼎投资大概成功投资了多少家上市公司？	stock
埃米尔冈公园：各色郁金香争相斗艳，徜徉在花海又是怎样的感觉？	news_travel
我借大哥50万做生意，大哥去世后大嫂这样还钱，让我惊慌失措	news_story
st保千里每天跌5个点，乐视每天跌10个点，乐视股价会跌过st保千里吗？	stock
江南化工：杭州银行扣划募资款的事项已妥善解决	stock
为什么有的姑娘不急着结婚？一张图告诉你答案，字字戳心	news_story
征兵高清海报来了！想去部队当兵的你还在犹豫什么？	news_military
给植物喷施硫酸亚铁的浓度是多少才合适？	news_agriculture
滑县蟒神传说	news_story
谢娜为李浩菲澄清网络谣言，之后她的两个行为给自己加分	news_entertainment
《碧蓝航线》舰娘120级排行榜 舰b120级PVE节奏榜	news_game
为什么大盘每天都翻红，个股却跌的比比皆是？	stock
重磅：“5050”计划打造全国人才生态最优区 “国际滨”蓄势待发	news_finance
情报站｜泰安女游客一家半夜迷路，热心护林员护送下山	news_travel
高考倒计时开始！看各国考生花样搞事情，让压力变浮云	news_edu
每天数字货币要闻（2018-5-6）	news_tech
公告精选：药明康德将于5月8日上市；南山控股换股吸收合并深基地B	news_finance
俄罗斯多地爆发集会游行，反对派领袖被捕、一天后获释	news_world
有1700年历史记载的隆中和有700年历史记载的卧龙岗，哪个更可能是诸葛亮的躬耕地？	news_culture
要知询农业专家，象怎样的高温天气，大地的西红柿与豆角是否天天浇水？	news_agriculture
如何对大脑进行投资该投资什么？	news_finance
大学毕业4年的儿子不肯外出工作，父母急得火烧眉毛	news_story
她15岁做艺妓53岁拍全裸写真76岁跳钢管舞，她是一名总统夫人	news_world
蔡徐坤粉丝见面会被激光笔照射 粉丝们你们要冷静啊！	news_entertainment
《后来》“退票门”或是“罗生门”，猫眼真的会自毁前途？	news_entertainment
出：窗含春夏秋冬景，下联怎么对？	news_culture
民间传说-吃亡人肉的风俗是如何改变的	news_story
“老公，你妈天天晚上来我们卧室门口听，难道她就不知道害臊？”	news_story
交警提醒：驾照扣12分和24分有什么区别？这些情况你一定要知道！	news_car
邻居上门问wifi密码，怎么有技术又不伤感情地拒绝？	news_tech
民间故事：男孩儿山中迷路被狼所救，义狼的行为感人肺腑！	news_story
你每天读书几小时？	news_edu
持股比例仅次于雷军，如何评价小米二号人物林斌？	news_tech
大学中庸小五月，如何接句？	news_edu
4月楼市成交同比降温 超8城市房地产市场调控加码	news_house
这条鱼被“通缉”了，他究竟做了什么？	news_world
现在在重庆投资房产还有升值空间吗？	news_house
LPL四大ADC主观排名，UZI走下神坛但依旧是LPL第一AD	news_game
上联：春夏秋冬交好运，如何对下联？	news_culture
鹿晗前女友曝光，比关晓彤还要性感漂亮 王思聪：你应该感谢我	news_entertainment
71岁施瓦辛格心脏手术后归来，与44岁女友双双现身	news_entertainment
30岁的男人应该开什么车？	news_car
雹灾对果树盆景的危害有哪些？	news_agriculture
雷军当年提出飞猪理论的时候，一定没想过会这样害人不浅！	news_tech
最美中级轿车，配12.3英寸大屏，售16万，后悔买凯美瑞！	news_car
为何奥巴马刚上台就获诺贝尔和平奖？他给世界带来和平了吗？	news_world
原来，那只是她自己的遗憾，与对方无关	news_entertainment
延边富德怎么了？主帅朴泰夏怎么了？	news_sports
小牛之后，EOS会不会倒下？	news_finance
为什么女子网球服下装是裙子？	news_sports
夜宿鬼庙，一句话救了自己一命，伸手不打笑脸人	news_story
美国法院判伊朗赔付9·11遇难者家属逾60亿美元，你怎么看？	news_world
几乎每一个银行工作人员都劝说顾客，不要把钱存入余额宝，对此你怎么看？	news_tech
葡萄盆栽卖“景” 能吃能观赏收益超传统种植10倍	news_agriculture
如何评价赵丽颖？	news_entertainment
山东理科生考试平均460分左右，高考会有突破吗？该怎么学习？	news_edu
华为手机越来越卡？赶紧开启这2个开关，用1辈子也不会卡！	news_tech
7旬哥哥带6旬妹妹隐居深山 养50头羊为生 照顾9旬卧床母亲	news_story
上海 4 月份新房供应量创 22 个月来新高！	news_house
芝麻信用分又更新了 马云：给600分以上福利！你芝麻分够吗？	news_tech
以色列警告称如果战机被击落将会轰炸俄军事基地，你怎么看？	news_military
山西首富是个初中生，第二名和第三名的财富加起来也没首富一半多	news_finance
大疆的概念股有哪些？	stock
西安无人机表演乱码 官方道歉称有定向干扰	news_military
“天虹七彩曜变”宁波茶博会再续天目传奇 探寻建盏复兴之路	news_culture
明日股市三大猜想及应对策略：指数将分化运行	stock
中超第九轮，山东鲁能0:0战平北京人和，错失登顶良机，怎么评价本场比赛？	news_sports
以色列警告称如果战机被击落将会轰炸俄军事基地，你怎么看？	news_military
“国六”即将实施，常用的“国三”“国四”会怎样处理呢？	news_finance
有什么高逼格的微信名字？	news_tech
焦虑的社会，焦虑的中国式教育环境	news_edu
即将中考的我	news_edu
中国001航母和辽宁舰哪个强？	news_military
保险业新锐面临转型 富德生命人寿等保费大幅下滑	stock
如何5分钟获取3W元以上额度的信用卡技巧？	news_finance
咖啡兰的养殖要点是什么，和其他品种有什么区别？	news_agriculture
美国封杀中兴通讯，不卖一颗芯片给中兴，究竟是为什么？	news_world
游戏时光本周热门：去完北欧，今年还有西部	news_game
为什么一个国家不能无限印钞票来让自己有钱，购买更多国外资源进行本国建设？	news_world
独角兽药明康德周二上市，但一季报净利已现业绩下滑	news_finance
股票波浪理论分析：各个波浪线的特性	stock
2018金秀瑶族自治县圣堂山杜鹃花旅游文化节推介会在南宁召开	news_travel
盘点全国环保行业最赚钱上市公司50强排行榜	news_finance
现代家庭教育中，是否存在所谓“知识倒挂”现象，你怎么看？	news_edu
小程序逐渐成为人们生活一部分，微信生态规则与流量玩法 资源	news_tech
骑士与猛龙G3，詹姆斯打板绝杀猛龙，这球是什么水平？	news_sports
要是朗逸plus只要12万起步，你还会买朗逸？	news_car
走进红色文化旅游胜地 领略路集千年古会风情	news_travel
今年东决如果骑士打凯尔特人，怎么样？	news_sports
算命（民间故事）	news_story
重庆8d魔幻之城要你好看，网红不简单，基建狂魔般任性2—铁路篇	news_travel
谁能娶她？29岁美女奥运冠军何雯娜重回体坛，想找长腿有腹肌男友	news_sports
分红后要除权，股价相应下降，股东也没多赚到钱，意义是什么？	news_finance
撒彩纸也不看清楚，打扫了足足七分钟！凯尔特人窃喜中！	news_sports
上联：田在心上思故乡，求下联？	news_culture
利比亚至今混战，卡扎菲众多女保镖去向成谜，结果超出预知	news_world
关于《腾讯没有梦想》	news_tech
乌鲁木齐开展“民族团结一家亲”主题活动	news_travel
重要信号：股市大涨近百点 逾20家公司密集增持25亿多	stock
农村的这些花花草草，你能随便叫出名字？	news_agriculture
5.5号比赛恒大金英权解围踢到球了为什么裁判给点球？	news_sports
英雄联盟号令之旗在职业赛场上大火，难道就没有一个AP英雄能完美克制吗？	news_game
产能扩充周期又起 “必需消费”重回热点舞台	stock
上联：解手，下联如何对？	news_culture
如果郑屠切了十斤寸金软骨，那鲁达还会提什么要求？	news_story
董子健王俊凯兄弟情：聊天表情包也要用小凯的！	news_entertainment
5月3日美联储决议在即，怎么看对A股产生的影响？	stock
国内首档体育跨界综艺秀《高能卡位·世界波》点映礼在京举办	news_entertainment
旅游｜宜兴人为什么都偏爱古镇	news_travel
小米在港上市之后，雷军身价有多高？	news_tech
女乒今天排兵布阵不合理，丁宁昨天刚打硬仗，今天应该打第一单打，你认为呢？	news_military
上证指数目前已形成2次的超大单资金的底背离了，已有条件见底了	news_finance
阿里云在全球处于一个什么地位？	news_tech
滑县庙会的会本哪里能买到？	news_culture
陕西这几个美得惊艳的地方，雄伟奇险 但是去的人很少！	news_travel
大智慧烧14亿给李大霄罗杰斯做直播，结果亏17亿要退市了，这是谁的锅？	news_finance
东莞工厂门口的求职年轻人，正在门口等着厂家来招聘	news_story
萨达姆死后，他的后代现在在何方？	news_world
经常更换微信头像的人是怎样的一种心理？	news_tech
控枪？拥枪？美国民众存在根本分歧	news_military
上联“一撇一捺写人生”，征下联？	news_culture
14年前的券商倒闭潮：熊市死于激进，自营炒股亏损几十亿，救不活	stock
十年车龄的蓝色日产370Z，夜惑街头！	news_car
如果给你三十万，你会选择什么车？	news_car
独步全球！沈飞又一款五代战机量产，性能让F35望尘莫及！	news_military
村里“最为难”的3种人，要提前避免这种遭遇	news_agriculture
每亩最高赚七八千 盱眙小龙虾如何“步步高”	news_agriculture
「爱人有新欢」	news_story
退休后工人农民全部免费医疗，养老金统一，会怎么样？	news_world
余额宝升级以后，预期收益率是否会回到6%？	news_finance
他是最帅反派专业户，演《古惑仔》大火，今病魔缠身可怜无人识！	news_entertainment
黄磊喜得贵子却被批重男轻女 他直言第三胎我更想要女儿	news_entertainment
汽车一定要在4S店贴膜吗？	news_car
北京西二旗月薪5万的程序员真实生活状态什么样子的？	news_tech
2018-05-06 区块链中，代码即是法律？	news_tech
董卿《朗读者》：一份给孩子最好的教育，为孩子收藏，作文满分！	news_edu
梨树上结“金子”，树下生“票子”，来看看他的生财之道	news_agriculture
超越英国！全球第五大经济体不是国家而是这地区……	news_world
10万元体验驾驶乐趣？看2016款新桑塔纳1.6L手动舒适版	news_car
哦！中国第114个世界乒乓球冠军——王楚钦！为中国对加油！	news_sports
众泰这次又火了，全新车标比“玛莎拉蒂”还帅气！	news_car
lol哪个英雄最吃操作？	news_game
各国如何与特朗普打交道？BBC：这些“奇招”了解一下	news_world
破净股数量超80只：市场见底信号？	stock
农村在这个季节家家户户种的豌豆已经成熟了 那你们家的呢	news_agriculture
未来取代app通信的方向在哪里？	news_tech
3000到5000的手机，有什么好的推荐？	news_tech
为什么人眼晴能一下就能看到几十亿光年的星星？	news_entertainment
海口和琼海，哪个地方更适合居住，房价大概多少？	news_house
不仅首季业绩持续高增长，这些股中期业绩仍可期	news_finance
梦幻西游：土豪被美女骗钱骂屌丝，一怒之下买175张号复仇	news_game
强势围观！莱芜楼市迎来“大洗牌” 这些新盘即将入市 热度爆表！	news_house
华为手机关掉这几个开关，缩减手机耗电量，提高待机时间	news_tech
「大事记」周巷安邦郡园最新消息	news_house
申万宏源：龙头房企业绩增长确定性最高	stock
谢娜复出即获两项“吉尼斯世界纪录”，女神吉尼斯与粉丝难舍关系	news_entertainment
北京餐饮行业用工供、需居高 难堵用工缺口	news_finance
《街舞》总决赛韩宇pk田一德夺冠，网友：可惜杨文昊battle没看够	news_entertainment
大魔王带头唱歌！火箭这像是打季后赛？爵士神帅这话已提前投降了	news_sports
王者荣耀：S11值得买的这几位13888英雄，要把钱花在刀刃上！	news_game
美航母空袭之后 大批美特种兵参战：叙利亚爆发新战争	news_military
山东各地抓住小麦孕穗期关键时期防控病虫害	news_agriculture
历史上的十大军事人才有谁？	news_military
银行加息对房价走势有何影响？	news_house
脂肪肝怎样最快消失？	news_sports
在西安买房哪个位置性价比比较高？	news_house
观点：部分贫困群众各种“怕”是迟滞脱贫因素	news_agriculture
王者荣耀里钟馗的钩子和百里玄策的钩子哪个更可怕，你更怕哪个？	news_game
我国古代就有火炮，为什么没有继续微型化发展出火枪？	news_military
为什么日本人很少有艾滋感染者？	news_world
美国建国不过两百年，为什么会成为世界强国？	news_world
教育｜4119人！武汉大学自招初审通过人数创纪录	news_edu
开封电子科技学校2018届学前教育专业毕业汇演精彩纷呈	news_edu
王者荣耀怎么看赵云打野Alan的回归？	news_game
A股牛熊变色，深度被套如何自救？	stock
美4月就业数据欠佳 国内经济短期承压	news_finance
十字坡一战，孙二娘彻底被武松征服，从此对武松刮目相看	news_culture
丰田这次火了！小号“霸道“亮相，2.7L+四驱，25万起后悔买途观	news_car
为什么国产手游做不出好游戏？	news_game
CF武器9A91怎么样？	news_game
洛瑞缠着詹姆斯，导致詹姆斯倒地差点儿引发冲突，为何要吹詹姆斯犯规？你怎么看？	news_sports
农业银行日照岚山支行举办青年演讲比赛	news_finance
《愚公移山》应不应该退出初中语文课本？	news_edu
想在西安买房投资，哪个区域比较好，最好有具体楼盘？	news_house
农村建房，明明砖混结构便宜，为什么有人还会要框架结构？	news_house
如果美国各个州独立了，世界格局会发生什么变化？	news_world
詹皇绝杀乐福21+16，骑士险胜猛龙总比分3-0，你怎么看？	news_sports
中新债后多久能上市？	stock
月老的传说：月下老人解姻缘，姻缘书上无更改，缘分是天定！	news_story
深圳地铁“扫码过闸”下周二正式上线	news_tech
印度 女孩遭15人绑架/村委会：罚两人做俯卧撑	news_world
以色列警告称如果战机被击落将会轰炸俄军事基地，你怎么看？	news_military
龙头惨遭砸盘透重大暗示 下周初变盘风暴或骤然来袭？	news_finance
斗鱼嘉年华美年达展会艳武汉，人气爆棚成为最大赢家！	news_game
房地产税改革渐行渐近	news_house
泰山医学院同等学力申硕火热报名中……	news_edu
我要曝光一下岳母和妻子的聊天，为这样的岳母点赞	news_story
2000左右买什么手机？	news_game
万科4月合同销售额418.9亿元 新增22地产项目	news_house
特朗普的淡漠反应，背后复杂而巨大的利益牵扯，美国会禁枪吗？	news_military
纸质水瓶面世了，塑料瓶子在饮料包装市场的命运将如何？	news_finance
河北高校毕业生注意！你关心的就业创业政策来啦，看仔细→	news_edu
“国民技术”的产品都应用在什么地方？	news_tech
"皇"和“王”哪个地位更高？	news_culture
看完这些聊天记录，你也许再也不想离婚了！	news_story
招行、工行、农行、建行和中行五行的信用卡哪个最好用？	news_finance
现藏于台北故宫博物院的褚遂良《倪宽赞》欣赏	news_culture
部分上市公司自然人股东持股数量保持增长态势	stock
LOL每天后半夜都会有自动送人头的，都是0-几的，查看战绩都是连输的，这是为什么？	news_game
「中考题型」物理想得满分？容易！只要你认真做这套题型！	news_edu
如何才能享受8%的定存利率？	news_finance
玉米价格最好的上涨时机或许在6月下旬 秋季价格也不要太悲观	news_agriculture
权志龙，黄景瑜，易烊千玺5月刊-你更喜欢谁的风格？	news_entertainment
家长为孩子交学费，但却受到教师的轻视，校长说的话让她羞愧不已	news_edu
最强星声PK戏精之王，新星盛典决赛闪耀苏州！	news_entertainment
攀爬雕像、随地大小便，“五一”沈阳景区这些现象你怎么看？	news_travel
方法论｜大小盘基金组合再探：中美两国股市的组合变通比较	news_finance
MSCI下周公布最新调整，中金公司料229只A股或被纳入	stock
零售企业开发自有品牌的三大痛点	news_finance
《像我们一样年轻》杀青 陈翔陈瑶携手创业大餐	news_entertainment
吃红心火龙果过时了！2018流行吃黄龙火龙果，1斤才300块	news_agriculture
郑眼看盘：结构性行情 尽量避开冷门股	stock
明星吃相大比拼，谁最可爱？谁最丑？	news_entertainment
上港主场1-2负于国安，遭遇联赛两连败，上港到底输在哪？	news_sports
长沙免费景点大集合！不花一毛钱就能玩遍大长沙！	news_travel
美国建国不过两百年，为什么会成为世界强国？	news_world
小米要上市了，有十万块钱怎么能买到小米的股票？	news_tech
本年度终身成就奖居然是他，和蔼可亲貌不惊人的老头	news_entertainment
玉米价格还会继续回落吗？	news_finance
如何评价《权力的游戏》里的托曼国王？	news_entertainment
晋唐小楷八种《唐刻宋拓晋唐小楷八种》大图欣赏，清代集本	news_culture
今日立夏，有一上联，立夏万物并秀，下联怎么对？	news_culture
无锡这个城市怎么样？	news_house
2018年房价还会涨吗，如果有五百万做什么投资？	stock
当年班里的小混混，现在都过得怎样了呢？	news_story
买公寓，一看城市，二看回报率，除此之外都是没用的？	news_house
为什么山东盛产学霸？	news_edu
《风云1》第二梦到底是不是明月，5个完美的理由告诉你真正答案	news_entertainment
跑跑卡丁车为何被QQ飞车击败？	news_game
退伍军人身上都有这3个“坏毛病”！百分之九十的人跑不掉	news_military
德国、英国和法国将派专家组前往以色列研究伊朗秘密核计划文件，普京该如何应对？	news_world
芜湖有哪些上市公司？	stock
马化腾都站台小程序，你觉得没机会，腾讯连接一切的野心就摆那里	news_tech
北控女足主场惜败	news_sports
手指是大脑发育的关键，这样锻炼，娃想不聪明都难	news_edu
官场小小说：《拐弯》	news_story
游戏圈的C位竟被这个男人占了 郭炜炜没想到自己“被出道”	news_game
驱魔浪人在哪儿可以看？	news_world
唐山今早必知的那些事儿	news_edu
一汽大众速腾1.6L手动家用动力如何？	news_car
妯娌流产住我家，儿子调皮拆了她的包裹，我气得和老公离婚	news_story
国金策略：下半年A股整体趋势向好 大票“搭台”优质成长“唱戏”	stock
MSI入围赛第一支晋级战队诞生！中国队的老朋友	news_game
乡村振兴需要工匠精神	news_agriculture
新手买房，是找中介好还是自己去售楼部买更好？有什么需要注意的？	news_house
万孚生物：内生性高速增长 进一步确立经营拐点	stock
成都本地人怎么看待成都的房价？	news_house
秦绪文：玩抖音怎么才能赚到钱？	news_agriculture
惊心炫目，小学还能开三语班？昆明仅昆理工附小一家	news_edu
2015版的长安奔奔还值得购入吗？	news_car
「司法拍卖：理想小镇」双拼别墅 带车位/车库 南北朝向 可贷款	news_house
拒绝雷同！《幻乐之城》全原创模式 呈现音乐加表演顶级大秀	news_entertainment
国内这座古城投资20亿，不收门票却游客稀少，当地人都不愿意去	news_travel
你心目中的伟人是谁？	news_culture
南京嘉恒有山二期别墅住宅什么时候交付？南京嘉恒有山-云有山苑	news_house
公子扶苏为何心甘情愿自尽？	news_entertainment
怎么评价潘乱写的《腾讯没有梦想》？	news_entertainment
上联：上班为下班，如何对下联？	news_culture
虽是冷门但也是好车，居然也有大众！	news_car
民间故事：放下屠刀，立地成佛	news_story
持有的股票一直不卖能等到牛市大涨吗，什么时候才能牛市大涨？	news_finance
LOL：三级时诺手被这三个英雄单杀，一点都不丢脸	news_game
安德森数据依旧犀利！对比之后并没有变化，德安东尼在下一盘大棋	news_sports
西安的特产在哪可以买到？	news_travel
跑完高速后，你的密集恐惧症犯了么？	news_car
88岁的奶奶从来不吃肉，就单爱吃这个菜，眼不花耳不聋走路特利索	news_story
蔡徐坤、范丞丞公关做得太浮夸，这一波微博数据一看就很假！	news_entertainment
kpl明星赛最大的败笔是不是替补坐了两场冷板凳？	news_game
你会为了《逆水寒》而放弃《剑网三》吗？	news_game
你对哪些世界未解之谜感兴趣？	news_edu
《温暖的弦》原本是由黄晓明担任该剧男主角，可现在却被换成了张翰，这事你怎么看？	news_entertainment
俄罗斯如今左右为难，支援叙利亚受阻，只因影响到这个国家	news_world
湘西赶尸之术，收徒有三条件，后两个太怪异！	news_story
一水二浪三死神 浓眉做花迪做叶 横批？	news_sports
全国首个人工智能课程走进中小学课堂	news_edu
《爸爸去哪儿6》嘉宾确定，老爸团颜值超高，他却拖了团队的后腿	news_entertainment
上交所高层变动！总经理黄红元将升任理事长	news_finance
停车先拉手刹还是先挂P档？老司机3句话让你茅塞顿开，太精辟	news_car
华池县马铃薯产业有序发展	news_agriculture
你怎么看待父亲精神分裂，母亲下肢残疾的他高考却被清华录取？	news_edu
个人独资公司购买的房产转到法人名下需要缴纳哪些税费？	news_house
遇到抢劫，但在他们没注意的情况下跑了，他们在追的过程中被路过的汽车撞死了，如何进行责任划分？	news_car
水产疾病频发、养殖成功率降低、产量急剧下降，水质恶化怎么办？	news_agriculture
华晨宇是否会成为新一代歌手代表，成长为划时代人物？	news_entertainment
弟媳让我垫钱买化妆品，手机屏幕一亮，我决定从此不来往	news_story
为什么江苏大学不在南京？	news_edu
侨报申请大学系列讲座 谷歌工程师林世彪主讲计算机专业与择校	news_edu
巷道年久失修，严重影响出行	news_agriculture
产蛋率有下降了，高手有几点指导意见	news_agriculture
为什么爱车 空调不制冷？大多数车主不清楚，搞懂后车内清凉一夏	news_car
德甲官方第33轮最佳阵容：J罗入选 马里奥-戈麦斯在列	news_sports
截止至2018春季赛季后赛，谁是lck第一adc？	news_game
已成为美俄刀俎上的鱼肉，乌克兰的出路到底在哪里？	news_world
以色列警告称如果战机被击落将会轰炸俄军事基地，你怎么看？	news_military
农民2018年土地确权后，20岁以下没土地的人怎么办？	news_agriculture
2018陆家嘴金融城足球联赛昨天拉开帷幕	news_sports
女神来了！汤唯着浅V白裙秀美腿出席活动 大方挥手笑容温暖迷人	news_entertainment
「中国制造」系列专题连载之——金漆木雕	news_culture
为什么主力资金流出，股价没有大跌反而上涨？	stock
陈立农粉丝见面会 演唱浓糖版的《纸短情长》！真的太暖心了！	news_entertainment
经常收到银行的办信用卡的信息，说是白金优质用户，是真的吗？	news_tech
上联：老子骑牛读书，下联怎么对？	news_culture
2018年第一季度车企销量增幅排行榜！看看哪个品牌势头最旺！	news_car
真相惊人！白马股闪崩频现 到底是赚钱机会还是割韭菜陷阱？	news_finance
西安的高校有哪些“最”？	news_edu
美网络司令部升级 日裔陆军上将中曾根就任新司令	news_military
夏威夷基拉韦厄火山喷发 滚烫熔岩横穿公路	news_world
宝爸姓老，给孩子起的名字太有水平，连老师上课都不敢提问	news_story
如何做T+0！一招轻松解套？	stock
身价仅值300万美刀却获中超1亿报价，瑞士巨星嘲讽这点钱太少了！	news_sports
如果房价突然降了，大家都买得起房子了，接下来会怎么样？	news_house
美国是怎样进行爱国主义教育的？	news_edu
世界杯第一战队卷土重来！集齐六大巨星强攻大力神杯	news_sports
武汉：开发商不得将“房查”作为购房的前置条件	news_house
这是最好的漫威英雄，还是最差的漫威英雄？	news_entertainment
《无限歌谣季》热播 张绍刚毛不易组合似“父子”	news_entertainment
读《唐诗三百首》之七言绝句之李商隐	news_culture
奇幻！大叔生日当天退休买彩又中1000万	news_world
为什么芯片那么难制造？	news_tech
小小说：李书记卖鸭	news_agriculture
才子的行书这样美，没有不学的理由	news_culture
如何做到更好的设计、更高的质量、更低的价格、更多的收益？	news_tech
一周楼市：第六届科博会总体方案确定 城区500余套公租房接受申请	news_house
用超过1亿元的资金回购公司股份，这3家公司是怎么了？	news_finance
你玩的第一款网络游戏什么？	news_game
现在农村都兴种这种果树了，好打理、易结果，一年都不吃完	news_agriculture
被拍拍贷追债什么感觉？	news_tech
刘亦菲参加活动近照，不小心把咖啡泼导演身上，网友都替她心疼！	news_entertainment
为什么扎扎帕楚里亚被网友戏称为“闪垫侠”？	news_entertainment
蓉华夫人与杨坚的故事，真的很有趣	news_story
为什么中国不能像美国针对华为手机一样也针对美国苹果手机禁售？	news_tech
跟老公去民政局离婚，工作人员给我递眼色，看老公脸我决定不离了	news_story
悄悄告诉你，如今不少果农选择这些“金牌”果树，果子清甜可口	news_agriculture
买了太平人寿保险，得了病花了20万，保险公司说没有动大手术拒赔怎么办？	news_finance
如何看待“自由搏击与传统武术谁厉害”这样的问题？	news_sports
百度和谷歌的差距在哪里？	news_tech
秦腔流派介绍：衰派，马连良称赞他是“衰派老生中的一绝”	news_culture
幽默大学第2课：幽默基本公式之连接词	news_edu
有什么好的餐饮开业的营销方案？	news_tech
观网小编进军营！全景展示74集团军	news_military
美国参议员麦凯恩说他的葬礼上不请特朗普，大家怎么看？	news_world
张震低调现身机场颜值20年没变 网友：羡慕航空姐姐	news_entertainment
信用卡逾期，已还本金10万，银行还要催收15万逾期利息怎么办？	news_finance
上联：草根登上星光道，怎么对下联？	news_culture
营收是阿里的两倍，市值等于三个沃尔玛，利润却只有阿里三分之一	news_tech
如果证实反政府武装使用化学武器，美英法会被追责吗？	news_world
上联：对牛弹琴牛尾舞，如何对下联？	news_culture
成龙改口决定不裸捐了，20亿财产给儿子一半，你怎么看？	news_entertainment
千应助学——人才扶持培养政策实施方案	news_edu
光头好看的人是真的好看，那些剃了光头的明星，最后一个最帅！	news_entertainment
这些真实而又残酷的历史照片	news_world
这款最帅气的国产SUV一来，奥迪A7失去光芒，售价和油耗都低	news_car
红海行动中，队长他们解救人质后为什么不直接偷坦克离开，而要和恐怖分子爆发冲突？	news_military
你见过最狂的一句诗词是什么？	news_culture
为什么唐山有钱人这么多？	news_travel
天上阿里，最精华的都在这个三国交界的边境县	news_travel
把支付宝里的收款码发给别人安全吗？	news_tech
鲜蒜、蒜薹今年恐怕“狠”不起来 多地出现免费送	news_agriculture
男医生娶个娶个女护士，是什么体验？	news_story
除了华为、阿里巴巴以外，你还知道哪些称霸世界的中国高新企业？	news_tech
70%的美国人真的连1000块钱都拿不出来，没有任何储蓄吗？	news_world
江疏影红套装现身喜庆惹眼 对镜噘嘴比V心情好	news_entertainment
亚洲杯夺冠赔率：日本、伊朗领衔 中国竟与泰国并列	news_sports
四川游客张某带着六名女子在三亚沙滩烧烤被撒沙，这事你怎么看？	news_travel
你充过钱的游戏中，哪些游戏是你最后悔的？	news_game
关于南半球的六道题你会几个？测一测吧？	news_agriculture
古堰故事——青城山下白素贞	news_story
为什么宁愿花钱租房也不住免费宿舍？打工妹诉说其中缘由，太心酸	news_story
日本强硬向美说不，是真心还是作秀？	news_military
女明星产后患上“妈妈手”！这病或许你也有	news_entertainment
美国富人的那些豪宅	news_house
茄果类高产第一步	news_agriculture
婚后三年不孕，不料婆婆却怀上了，公公提一建议，我笑岔气	news_story
美国近来不断扩张军力增加国防预算，恢复第二舰队，战略政策是扩张性的吗？	news_military
美国撤出北约的可能性有多大？	news_world
故事：只要明白这个道理，妖怪鬼怪根本就伤不到我们	news_story
中甲最新积分榜：梅县铁汉21分钟连入6球打爆辽宁宏运升至第七	news_sports
四川游客张某带着六名女子在三亚沙滩烧烤被撒沙，这事你怎么看？	news_travel
怎样才能更好的激励自己学习和成长？	news_edu
店铺分销模式，分销宝智能化采集让你出单变得简单	news_tech
没有雄厚资金的创业者，如何最大程度提高成功创业几率？	news_finance
现代领动最高优惠 最低报价 可分期	news_car
荣威Tx3、瑞虎7、帝豪gs1.8T和吉利帝豪gl哪个好？为什么？	news_car
时间过去将近两年了，大家是如何看待杜兰特加盟勇士这件事情？	news_sports
猪场发生猪痢疾，给猪用这个方法治疗，1天控制死亡	news_agriculture
券商、交易所携手“捉妖” 涉及频繁异常交易等将被重点监控	stock
侯森：给自己定位代班门将，等杨智复出国安会更进一步	news_sports
亚洲杯分组国足抽得上上签，国足就一定能出线吗？	news_sports
上联:青丝一任凌风乱，如何对下联？	news_culture
小米会布局除cpu以外更多的芯片吗？	news_tech
意甲第36轮 切沃2:1力克克罗托内 收获胜利	news_sports
武汉再提城乡低保标准 城市每人每月提高到715元	news_agriculture
以色列警告称如果战机被击落将会轰炸俄军事基地，你怎么看？	news_military
王者农药，一场打到虚脱的游戏，大家最多打多长时间？	news_game
在延津有一种聊天叫喷空儿	news_agriculture
好好把握比特币的调整 每次都是机会	news_finance
农村非常普遍的野草，却有三大神奇功效，你肯定见过	news_agriculture
农村大叔野外抓螃蟹，却收获了这么多的小石头！	news_agriculture
以色列警告称如果战机被击落将会轰炸俄军事基地，你怎么看？	news_military
自动驾驶、医疗、能源……一季度融资最多的人工智能公司	news_tech
帝豪GL1.8自动精英裸车价86800，买贵了吗？	news_car
亲爸和婆婆同1天生日，老公不让回娘家，和婆婆吃饭时我惊喜落泪	news_story
五四运动中遭世人唾骂的卖国贼曹、章、陆三人，最终结局如何？	news_military
重机云集的醉美江南机车节上谁“最美”？胡军李亚鹏告诉你答案	news_car
通讯：政府资助 社会支持——挪威全民参与“海滩清洁日”活动	news_world
「会计初级资格证备考」天天上班加班将如何备考呢？	news_edu
金茶花该怎样养护？	news_car
以色列警告称如果战机被击落将会轰炸俄军事基地，你怎么看？	news_military
5日游戏热点回顾：王者荣耀：玩家求官方加强猴子，别改李白，策划一一答复	news_game
自3月23日以来，A股持续在3100点附近震荡，股市何时能突破该区域？	news_finance
印度建造的第一艘国产航母，为何先后用了20多年时间？	news_military
马略卡岛骑行的旅客指南—下	news_travel
私房拆迁分的房子是使用权，父母过世后，不在户口内的子女有继承权吗？	news_house
支付宝里可以直接查银行卡余额了！	news_tech
女生初中毕业适合学什么专业？	news_edu
自考学历社会认可度如何？	news_edu
“限酒令”后，杭州酒店式公寓冲上4万+！别高兴太早……	news_house
NBA历史排名前十都有谁？	news_sports
为什么提起火箭队，很多球迷就会想起奥拉朱旺？	news_sports
特朗普的淡漠反应，背后复杂而巨大的利益牵扯，美国会禁枪吗？	news_military
让青春与奋斗同行——海南创业创新青年掠影	news_finance
国产独立游戏失落城堡销量20万+，能带来什么启示？	news_game
同学聚会上，女友一直喊太热，帮她解开外套后，我饭没吃就跑了	news_story
美国究竟发达到什么程度了？	news_world
2018河州牡丹文化月游客高峰再度来袭	news_travel
抵抗“惯性”很重要，纪录片选题的国外经验先看节展	news_entertainment
如果美国退出联合国怎么办？	news_military
狙击手为什么要在射击之前将第一枚子弹给退掉？90%的人都想不到	news_military
帕纳梅拉！动感又不失优雅！	news_car
银行卡没有钱，如果一直不用，每年都扣年费等等费用，十年二十年后，银行会主动来要费用吗？	news_finance
《英雄联盟》什么上单英雄能吊打鳄鱼？	news_game
高考专业相同或者相近，院校如何选择？	news_edu
瑞典世乒赛中国女队3-1日本女队卫冕，如何看待刘诗雯的表现？	news_sports
农村故事：刘氏祖坟有两个坟头，据说里面埋着两姓人家4个人	news_story
遭遇3连败，东部2队面临生死一战！坐拥主场优势，大帝有望破局？	news_sports
第五人格哪个监管者好？	news_finance
最新爆文｜存银行20万一年后亏了500，必须看看是怎么回事……	news_finance
2018年珠宝首饰行业最赚钱上市公司10强排行榜	stock
《DNF》玩家感叹；当时迫不及待头脑发热了一下，现在后悔莫及！	news_game
马克思的影响从未离开——法国再掀马克思主义研究热潮	news_finance
现在股市都是2―3元的很多，有哪些可以长期持有？	news_finance
别说你很懂！踩刹车也是有技巧的	news_car
四川九寨沟，美过童话的山水“九寨归来不看水”世界自然遗产名录	news_travel
你支持迷你还是mc？	news_game
《海王星》新作追加发售SWITCH版	news_game
LOL：新一代Soloking史森明，Uzi直播与小明单挑被完虐	news_game
王者荣耀：魔铠上分攻略，最暴躁的备战铭文、出装你敢用吗？	news_game
奈何桥的孟婆到底是谁？在地府处于什么地位？	news_story
携NBA完美还原球星生活最强NBA揭秘潮服、王朝两大新模式	news_game
王者荣耀：5个“小学生”最爱的英雄，进去就秒选的要小心了	news_game
EXID率智眼球开刀首露面！抗病1年近况曝光⋯粉丝哭了	news_entertainment
专家建议强制性要求上市公司披露环保信息	stock
印度是真的落后，还是只是在中国游客的眼中，印度很落后？	news_world
说动就动，说拍就拍	news_travel
如今社会如何看待专科、本科、研究生学历？	news_edu
多年前，把宅基地卖给了城里人，现在后悔了，能要回来吗？	news_house
转债罕现大面积负溢价 套利大军闻风而动	stock
大众朗行1.6自动挡用5w-30全合成机油还是5w-40半合成机油？	news_car
中国女人嫁非洲男人都嗤之以鼻，那中国爷们娶非洲女人你们怎么说	news_world
越南语学习篇之越南语中常用词语三十二，建筑行业词语翻译表格	news_travel
《荒野大镖客2》细节整理 支线、狩猎、荣誉系统	news_game
南京：对欺凌学生等行为零容忍 从重从快依法惩处	news_edu
想要干爽迎接夏天？这个汽车SPA少不了	news_car
王者荣耀里，后羿重做后究竟是增强了，还是不如以前了？	news_game
英雄联盟喜欢玩辅助的是什么样的人？	news_game
各股市的指标指数都不一样，如果，按照纳斯达克的标准，中国的沪市股指应该是多少？	stock
全球十大防空导弹盘点：中国只有一款上榜 排第7	news_military
维特尔：近几年莱科宁的状态被人们曲解了	news_sports
美术生去北京画室参加集训会不会影响联考成绩？	news_edu
刺激战场中比较难获得的称号有哪些？	news_game
大侦探：导演为杨幂发声怒怼网友，但韩雪、鬼鬼、王嘉尔才更憋屈！	news_entertainment
如何在香港开立证券账户？	stock
新潮能源16分钟刷天地板：有人近6亿砸盘 一线游资杀入	stock
这真的是一场屠杀，刚刚这个国家崩盘了	news_finance
49岁邓文迪，网友：霸气侧漏，如此汹涌澎湃！	news_entertainment
你真的会因材施教么？	news_edu
玉米心叶展不开是什么原因导致的？	news_agriculture
正能量 正楷标准教程4	news_culture
购买二手房，卖家反悔？	news_house
美丽乡村——小丘镇移村	news_agriculture
何为人格魅力？	news_entertainment
5秒破百/纯电续航44km，新款保时捷卡宴插混版曝光	news_car
大神飞车手游里结过婚了，戒指可以换吗？	news_game
照亮我人生的东辉老师，您在哪里？︱等着我寻人	news_edu
「陕西传媒网」西安机动车达300万辆 专家：道路规划影响拥堵	news_car
辽宁男孩考上大连某高校，父母办升学宴庆祝幅超过千米，网友批评太奢侈，你怎么看？	news_edu
黑白无常天生就是神仙吗？他们的真实姓名又是什么	news_story
「脱贫攻坚」贵阳市信访局积极推进脱贫攻坚“春风行动”	news_agriculture
就在男友和饭店老板还价的时候，我默默的离开了	news_story
iPhone X Plus真机现身：三摄对标华为 售价超一万 苹果真怕了？	news_tech
如何看待微信小游戏的爆红，是真机遇还是伪风口？	news_tech
微信打不开了怎么办？	news_tech
以色列警告称如果战机被击落将会轰炸俄军事基地，你怎么看？	news_military
人间四月芳菲尽 深山杜鹃始盛开	news_travel
估值近千亿美元！小米凭啥值这么多钱？真相了	news_tech
上联：多心未必是好事；下联？	news_culture
旅游风景电脑壁纸 适合旅游的自然风景	news_travel
军演时来敌人了怎么办？	news_military
怎样做一个类似拼多多的团购+分销的APP？	news_tech
巴菲特股东大会：关于中国，巴菲特、芒格说了这些	news_finance
犹太人为何一定要回到耶路撒冷地区建国？	news_world
泰伦-卢：当詹姆斯全力冲刺时，没人能防得住他	news_sports
如果百度的人工智能失败了，那么百度将何去何从？	news_tech
去香港买保险有何利弊？	news_finance
西安的房价还会涨吗？	news_house
刘亦菲撞衫赵丽颖谁更美？细数明星撞衫大集合！	news_entertainment
“三宜”一体兴乡村 陕西岚皋大力实施扶贫搬迁	news_agriculture
零基础学开亚马逊之一卖家后台首页讲解	news_tech
逼死实体店的电商，反过来大量开实体店是为啥？	news_tech
中国唯一的俄罗斯民族乡，归属于内蒙古，却住着30%俄罗斯族人	news_travel
第五人格：厂长把傀儡扔上房顶后发现不对劲，游戏就这样结束了？	news_game
何炅为谢娜冒雨进村买鸡蛋？网友知道原因后被暖哭：这是一筐友情	news_entertainment
真急了！詹姆斯与洛瑞发生冲突，三分回应再现死亡之瞪+绝杀比赛	news_sports
婚房由男方支付首付和每月月供，如果离婚，女方能分到钱吗？	news_house
一加6手机需要抢吗？一加的系统和小米比怎么样？	news_tech
死里逃生的小蝌蚪	news_story
欧阳询《皇甫诞碑》，可为初学者借鉴，甘苦之言	news_culture
如果安卓系统手机没有流氓软件，安全性提高，国产机的份额是不是还会上升？	news_tech
《2018年春季深圳人才供需与流动报告》发布，平均42人竞争一个职位！	news_tech
同一个品牌的高配汽车和低配汽车的发动机一样吗？	news_car
怎么看小车轮胎的日期？	news_car
车主必须要了解的汽车玻璃知识	news_car
为什么连续涨停要停盘调查而连续跌停不用，难道涨停比跌停更容易危害证券市场的稳定吗？	stock
书上说，地球上大量的雨水蓄满了火山口，形成海洋。雨水是淡水，海水为什么是咸的？	news_travel
十五万存银行 每年多少钱 算一下！	news_finance
南宁有哪些有特色的小酒馆？	news_travel
现在想要脱坑都这么难，老马硬生生拉玩家回坑，这代价有点大	news_game
怎样提高阅读能力？	news_edu
世界上原始生态环境保存较好的自然保护区-可可西里	news_travel
上联：东方有新日，扫却万里愁云，如何对下联？	news_culture
雪糕袋子上印有“清真”两个字到底是什么意思？	news_world
婆婆因儿媳拿钱给娘家大吵，儿媳一激动说真相：我跟你儿子早离了	news_story
人类会不会进化到遗传记忆？	news_tech
为何奥巴马刚上台就获诺贝尔和平奖？他给世界带来和平了吗？	news_world
吃鸡再次引发社会事件，背后事件值得深思！	news_game
上联：若不撇开终是苦，如何对下联？	news_culture
成功人士用华为，穷人用苹果，屌丝用小米，事实果真如此吗？	news_tech
中国哪里的脐橙最好？	news_agriculture
日本地铁为什么没有安检？	news_world
王子文工作室发严正声明，王子文贴心安慰助理：委屈你了！	news_entertainment
为什么券商先知道中签号？	stock
特朗普所做的一切会不会只是为了自己的商业帝国？	news_house
轴承安装方法有哪些？	news_tech
南阳：政企携手 创新模式 带动贫困户增收	news_agriculture
股票补仓没有用到这个凯丽公式，会越补越套吗？	stock
作为俄罗斯总统，普京上台以来有哪些失误？	news_world
故事：捉 奸	news_story
揭密1990年日本大股灾房、地产泡沫真面目	news_finance
房价走势如何？	news_house
汉腾汽车首款MPV，想做车市黑马，先问问宝骏730同意不	news_car
春天的北京箭扣长城，冰雪奇缘	news_culture
我省突破秸秆生物炭规模化技术，生产成本仅为国外的15%	news_agriculture
怎么理解网上对这句「I like you, but just like you」 的翻译？	news_edu
王者荣耀：玩家炫耀15万金币账号，却被网友一张图打脸扎心了！	news_game
柑橘根系总出问题是什么原因？	news_agriculture
区块链游戏哈希世界新增南极土地玩法，可领比特币	news_game
如何在尾盘的半小时内判断次日涨跌行情？	stock
2018年太原市中考体育考试将于5月19日开始	news_edu
以色列警告称如果战机被击落将会轰炸俄军事基地，你怎么看？	news_military
胖子游记-大美甘肃张掖篇（二）	news_travel
今年起亚将会大反扑，三款车型可与国产车抗衡，最后一款势不可挡	news_car
中国最热的地方—新疆吐鲁番火焰山	news_travel
LOL创造了吉尼斯纪录的英雄 第一是人面兽心 第三来自地狱	news_game
房价终于跌了？“深圳房价19连跌”	news_house
刚买H6就后悔了，猎豹新车比奥迪漂亮，搭宝马1.6T动力，仅11万起	news_car
都说80年下海、90年炒股、00年炒房、10年炒比特币，那么现在该干些什么？	news_finance
如果2018骑士夺冠，詹姆斯这个冠军的含金量有多大？	news_sports
离开高通小米将会怎样？	news_tech
教师资格证作文高分素材—倾听	news_edu
不玩AI套路 360手机N7诠释智能本质	news_tech
科尔不满隆多垫脚库里欲向联盟投诉隆多，要是莱昂纳德听到这消息会有什么感觉呢？	news_sports
户外直播跳舞的爽儿为什么出镜率那么高？	news_travel
浙江外国语学院	news_edu
市场分析｜原药有涨有跌，2018年农药行情扑朔迷离？	news_agriculture
大连一方3:0完胜恒大，足协杯出局、又被一方大败，恒大怎么了？	news_sports
有50万的资金买车还是买地？	news_agriculture
如何查找静电？	news_tech
四光棍老汉，深山甘做“苦行僧”，清苦生活一天一顿 过午不食	news_story
陈道明63岁，张国立63岁，而63岁的他看起来像36岁！	news_entertainment
现代化牛场都要什么设备？	news_tech
世界第一伟人是谁？	news_travel
老光棍心善救狐狸一命，去世后五子抬棺，老道说他们乃是狐狸变化	news_story
股票放量下趺，大资金出逃谁在接盘？	stock
子女和父母在同一个户口下，如何将子女名下的房产过户给父母？	news_house
谢百三逝世前是怎么告诫中国股民的，如何理解？	stock
车上零碎物品多没地放，车载座椅夹缝置物盒，不占空间还方便	news_car
300方的地，起6层，打桩起商品房和打桩起厂房，桩有什么不同？	news_house
世乒赛男团决赛：马龙樊振东许昕上场，奥恰洛夫受伤德国无奈变阵	news_sports
如果朗多进入转会市场，哪些球队适合他？	news_sports
联合国安理会改革废除一票否决权，会导致什么后果？	news_military
四季如春的昆明有哪些冷知识？	news_house
老公是生物老师，每天回来心事重重，偶然看到他手机，我喘不上气	news_story
攀枝花哪些中学教学质量好？	news_edu
法国劝说奏效，伊朗为打消顾虑愿加入对话，特朗普还会退出伊核协议吗？	news_world
不考虑核武器，只是常规武器，美国多久能打赢俄罗斯？	news_military
2018年A股百亿富豪：何享健成首富 贾跃亭退出榜单	news_finance
网易商丘诚寻合作伙伴 期待与您合作共赢！	news_tech
全场空勾也让人惧怕三分！王者荣耀遇到钟馗简直是斗智斗勇！	news_game
开州工匠李文波，一把刻刀写春秋，醉心雕艺铸辉煌	news_culture
下联：游古镇，抚古筝，古意正浓。怎样对上联？	news_culture
人被原子弹炸死时，到底有多痛？	news_military
西安机动车保有量突破300万 交通治堵成焦点	news_car
第十四届“多浪·龟兹”文化旅游节5月12日开幕	news_travel
中国十八世纪时，都有哪些著名的诗人？	news_culture
长五总装团队：正值芳华肩负新使命 我为祖国铸利“箭”	news_military
骑士再胜猛龙拿到赛场，场边泰伦卢采访通过乐福花式盛赞詹姆斯	news_sports
2018年，东风商用车这些事值得关注！	news_car
以色列警告称如果战机被击落将会轰炸俄军事基地，你怎么看？	news_military
注意了，农村今年有4个坑，有农民已经愁坏了	news_agriculture
潍坊旧事:走夜路谁叫你都别答应	news_story
这种农村的美味在哪都能生长，曾经泛滥成灾，现在卖到50元一斤	news_agriculture
江西“落单”白鹤恢复状态良好 明日乘飞机至吉林放飞	news_agriculture
哪种发酵剂发酵猪饲料比较好？	news_agriculture
雅阁，凯美瑞，天籁后期费用，大约都多少钱？	news_car
美国天天打仗，为什么还那么有钱	news_military
白富美代表綦美合为了陈飞宇手撕欧阳娜娜？网友：王文也没参与吗	news_entertainment
以色列警告称如果战机被击落将会轰炸俄军事基地，你怎么看？	news_military
马化腾回应腾讯没有梦想，他回应说的话符合他一直做的吗？	news_tech
当发现女友只是将自己当成钱包，你会怎么做？	news_story
特朗普否认给艳星13万美金封口费 不料律师说漏了	news_world
股票书籍分享——技术分析之五档买卖盘，还要练习盘感	news_finance
天津工业大学和南昌大学，哪个好？	news_edu
南宁城市怎么样？适合东北人生活吗？	news_travel
立夏：春红落尽，夏木成荫	news_culture
宁愿在国外过得贫困潦倒，住得像贫民窟，也不愿回国的华人	news_story
荣威MARVEL X首发如何做到“三过硬五第一”？	news_car
现在买房去售楼部都说卖完了，究竟谁买的呢？	news_house
职场小故事：谁动了局长的保健茶	news_story
越来越多夫妻自驾游不去酒店，义乌造“房车神器”，真是大开眼界	news_car
家长们看过来，南充清泉坝将建2所学校，孩子上学不用愁	news_edu
蓝星生财之道公众号增长计划0.2版本	news_finance
深圳房价连降19个月，为什么买房者还嫌不给力？	news_house
温室西红柿怎么种植？西红柿现代温室种植	news_agriculture
共享情人……	news_story
李逵临终前，含泪说了22个字，揭开了宋江的真实面目	news_culture
英语一天一句跟我读（第36天）	news_edu
上港主场1-2负于国安，遭遇联赛两连败，上港到底输在哪？	news_sports
闺蜜生日，我用男友手机给她发红包，她的回复让我泪流不止	news_story
NBA如果用带队能力给现役球星排名，前五都有谁？	news_sports
支付宝-好医保VS微信-微医保	news_tech
重庆正在修建一条铁路，预计2020年底建成通车，沿线城市发达了	news_travel
赚钱也没时间花，娱乐圈有多少像张钧甯这样的人？钱都去哪了？	news_entertainment
MPV也加价？这款7座MPV，3米2 轴距2.0T比GL8还帅，还要GM8干啥	news_car
创新思考产生创意直至实现产品	news_tech
从北京自驾去新疆怎么走合适？	news_travel
凤姐罗玉凤，靠什么能力在美国生活？	news_entertainment
后来的我们，抢先看	news_entertainment
为什么大盘指数涨了那么多，很多个股都跌的比股灾还低？	stock
九月想自驾去西藏，如果我开车去，朋友坐我的车，费用怎么算才合理？	news_travel
我小时候喜欢阿拉蕾，因为带上眼镜长得像她，于是总被同学让我带眼镜模仿，结果久而久之，我就成了近视	news_entertainment
金晨出席活动现场表演 网友：对，这大长腿就应该扛在肩膀上！	news_entertainment
2018年，股市最大的风险在哪里？	stock
这个电脑配置值多少钱？	news_tech
DNF：大家自嘲一下自己最缺哪件诗史	news_game
多年不见老同学再婚给我发请柬，我回了5个字，整个群都安静了	news_story
公车私用（幽默故事）	news_story
一篇很有意义的文章，希望您能耐心看下去	news_world
广西再建城际，不走南宁，却连接了这两个穷地方，1300万人将脱贫了	news_travel
东方最新作《不可思议的幻想乡 莲花迷宫》公布 将登陆PS4/NS	news_game
溥仪改造后回到北平准备结婚，旧朝老臣马上送来如花似玉的闺女	news_story
湖湘工匠丨黄彪：“薄施淡染”总相宜	news_culture
传小米阿里舜宇等八家公司列首批CDR名单	news_tech
强硬报复！俄战机猛烈轰炸，支美武装据点全部摧毁，美军没有发声	news_military
高尔夫GTI TCR公路版预告 5月底发布	news_car
养猪知识：母猪合圈方法 检验母猪是否怀孕方法	news_agriculture
要被真心大冒险这个水晶球男孩笑死了，强行霸道总裁尬到飞起！	news_entertainment
俄罗斯主战装备防空导弹被掀底牌，全靠一邻国“热心”卖给美军	news_military
流浪狗扰乱正常教学秩序，破坏学生们生活，该怎么办？	news_edu
交警查车也有“潜规则”，他们就爱拦这些车，几乎一查一个准	news_car
如何评价袁立？	news_entertainment
子女农转非后，承包地将不允许继承，满足6个条件，可以非转农！	news_agriculture
阴阳师超鬼王即将结束 谁是最强特攻式神	news_game
应该如何评价硬笔书法名家范林庆的书法水准？	news_culture
如果骑士今年一轮游，那么詹姆斯的历史地位会受影响吗？他还有机会再进总决赛吗？	news_sports
紫鑫药业董事长郭春林：三大业务为核心 迎接大健康时代来临	news_finance
中国四大园林分别在哪？	news_travel
证券业开放提速 一周内两外资机构申请控股券商	stock
县区丨新田：小辣椒成贫困村致富“火红产业”	news_agriculture
怎么看因为性侵丑闻，二战后诺贝尔文学奖首次停摆？	news_world
淘宝购物大家能接受48小时后发货吗？	news_tech
2018新财富500富人榜榜单来啦！	stock
为什么格力股价与美的差距越拉越大？	stock
四川游客张某带着六名女子在三亚沙滩烧烤被撒沙，这事你怎么看？	news_travel
上证指跌到1000点会怎么样？	stock
李诞说错话，何炅刘宪华满脸尴尬，张绍刚黑脸：少说话多吃东西！	news_entertainment
上联：清源山中鸟鸣喧，下联如何对？	news_culture
“天选之人”遭雷劈？你是否在装X，这个道具帮你检测……	news_game
国际油价创近三年半新高 国内油价今日料“四连涨”	stock
女孩们 如何从“改车”看出另一半是暖男或渣男	news_car
你还在为企业和项目的资金而发愁嘛？你会融资嘛？懂得如何融资嘛	news_finance
8省区4100亿养老金入市，对后市大盘影响有多大？	stock
东北经济的下一个增长点在哪里？	news_agriculture
A股纳入MSCI倒计时 利好四大板块	news_finance
利比亚至今混战，卡扎菲众多女保镖去向成谜，结果超出预知	news_world
离奇！男子叫网约车，竟然叫来一辆……他回想起来还有点怕	news_car
4.5都有了！猪场下一步该怎么走？	news_agriculture
上联：雨润百草盛，如何对下联？	news_culture
唐培科：带领村民们打造“新农村”	news_agriculture
如何看待世乒赛女队夺冠后，李晓霞微博霸气送祝福的行为？	news_entertainment
联合国安理会改革废除一票否决权，会导致什么后果？	news_military
去越南旅行，什么时候去比较合适？	news_travel
一起看房的哥们说房价1万太扯淡了，后来四万多一平，哥们蒙圈了	news_house
怎么去非洲开农场，做生意？	news_agriculture
孩子沉迷《堡垒之夜》！卫报：游戏没错，错的是时间	news_game
房价上涨买房想违约该怎么办？	news_house
瑞典世乒赛男团决赛，中国队面对德国队，应该派出怎么样的阵容？	news_sports
dnf玩家穿超大陆刷安徒恩屡屡被踢，朋友提醒后恍然大悟	news_game
今年这轮“猪周期”，大跌之后必有大涨吗？	news_agriculture
“色绿精神”休闲度假的理想之地 有机会一定玩！	news_travel
《英雄联盟》IG中单Rookie这名选手的水平到底怎么样？	news_game
又涨了！淄博市最新5月二手房价曝光，快看看你家又涨了多少？	news_house
有点闲钱了 放在哪里收益最划算	news_finance
“小豆包”进幼儿园科普消防知识	news_edu
蛋鸡养殖效益指标计算	news_agriculture
绝地求生：最想要的吃鸡神器	news_game
如何看待大学学习问题上的博广与精深？	news_edu
青岛这个区牛了！要建奥特莱斯、银座……还通地铁！	news_house
名爵ZS纯电版车型曝光，电子旋钮换挡，2018下半年上市！	news_car
村民地下挖出“人形大人参” 给专家鉴定后却是另外回事！	news_agriculture
乞丐捡到一个馊馒头，分一半给流浪狗，流浪狗为报恩送他一块金子	news_story
快中考了，父母怎样配合孩子能考出个好成绩？	news_edu
西安房价均价降了11块，还有继续降的可能吗？	news_house
法国突然宣布重要消息，特朗普大怒，中国却热烈欢迎！	news_world
那个给“二本师范生”讲课的奥数满分天才，在自白书里这样谈起“坠落”	news_edu
农村低保“政策”大幅度调整！农民：还改？让不让过了！	news_agriculture
刘继祖施舍朱元璋一块墓地，帮其安葬父母，子孙显贵三百年	news_story
18年5月7日这周的A股会怎么走？	stock
立夏苗山农事忙	news_agriculture
高度发达的外星人有复活死人的科技吗？	news_tech
马云放大招，网商银行转账全免费，马化腾腾讯微众银行如何应对	news_tech
怎么评价普京？	news_world
如果勇士今年夺得总冠军，是不是就算建立了王朝？	news_sports
地处合肥的中国科学技术大学与地处武汉的华中科技大学相比而言，哪个略胜一筹？	news_edu
南京证券上市倒计时：六年三次冲关却要换来两项尴尬纪录	stock
2018千人小程序峰会	news_finance
作为俄罗斯总统，普京上台以来有哪些失误？	news_world
日本和以色列为什么会在贫瘠的土地上建立起高度发达的国家？	news_world
英语六级很难吗？	news_edu
电信的业务都有什么坑？	news_tech
怎么来寻找和选择合适的投资商？	news_finance
福建茶企举办全球品鉴会 首站走进厦门	news_culture
15 分钟参透比特币和区块链	news_tech
为什么外国元首会见特朗普女儿伊万卡时都很开心？	news_world
05月06日潜江天气预报	news_finance
股票尾盘突然急剧拉升有什么意图？	stock
肥料造假新动向：几近乱真！	news_agriculture
股票增发和股票回购是正好相反的两种操作吗？	news_finance
对于生孩子这件事，黄磊的话让人尬，陈浩民渣，最暖心的是他！	news_entertainment
